ID,A,T,C,G,Total
lcl|NC_002695.2_cds_NP_308028.1_1,27,14,31,12,84
lcl|NC_002695.2_cds_NP_308029.1_2,554,608,610,691,2463
lcl|NC_002695.2_cds_NP_308030.1_3,194,214,232,293,933
lcl|NC_002695.2_cds_NP_308031.1_4,302,301,316,368,1287
lcl|NC_002695.2_cds_NP_308032.1_5,77,60,83,77,297
lcl|NC_002695.2_cds_NP_308033.1_6,209,188,186,194,777
lcl|NC_002695.2_cds_NP_308034.1_7,261,412,362,396,1431
lcl|NC_002695.2_cds_NP_308035.1_8,253,208,238,255,954
lcl|NC_002695.2_cds_NP_308036.1_9,137,134,143,174,588
lcl|NC_002695.2_cds_NP_308037.1_10,104,164,147,152,567
lcl|NC_002695.2_cds_NP_308038.1_11,189,161,169,195,714
lcl|NC_002695.2_cds_NP_308040.1_12,114,93,109,89,405
lcl|NC_002695.2_cds_NP_308041.1_13,537,395,476,509,1917
lcl|NC_002695.2_cds_NP_308042.1_14,276,232,278,345,1131
lcl|NC_002695.2_cds_NP_308043.1_15,56,47,47,60,210
lcl|NC_002695.2_cds_NP_308044.1_16,217,351,265,334,1167
lcl|NC_002695.2_cds_NP_308045.2_17,225,247,195,233,900
lcl|NC_002695.2_cds_NP_308049.1_18,757,689,498,507,2451
lcl|NC_002695.2_cds_NP_308050.1_19,261,173,135,115,684
lcl|NC_002695.2_cds_NP_308051.1_20,179,146,103,106,534
lcl|NC_002695.2_cds_NP_308052.1_21,540,423,243,216,1422
lcl|NC_002695.2_cds_NP_308053.1_22,89,52,66,57,264
lcl|NC_002695.2_cds_NP_308055.1_23,213,225,227,277,942
lcl|NC_002695.2_cds_NP_308056.1_24,648,599,738,832,2817
lcl|NC_002695.2_cds_NP_308057.1_25,92,139,125,139,495
lcl|NC_002695.2_cds_NP_308058.1_26,100,101,123,126,450
lcl|NC_002695.2_cds_NP_308059.1_27,220,206,231,294,951
lcl|NC_002695.2_cds_NP_308060.1_28,187,219,260,249,915
lcl|NC_002695.2_cds_NP_308061.1_29,190,197,182,253,822
lcl|NC_002695.2_cds_NP_308062.1_30,281,254,315,299,1149
lcl|NC_002695.2_cds_NP_308063.1_31,759,663,847,953,3222
lcl|NC_002695.2_cds_YP_009502587.1_32,80,61,40,38,219
lcl|NC_002695.2_cds_NP_308064.2_33,119,95,75,107,396
lcl|NC_002695.2_cds_NP_308065.2_34,129,136,138,188,591
lcl|NC_002695.2_cds_NP_308066.2_35,186,176,192,232,786
lcl|NC_002695.2_cds_NP_308067.2_36,390,377,373,414,1554
lcl|NC_002695.2_cds_NP_308068.1_37,315,264,328,311,1218
lcl|NC_002695.2_cds_NP_308069.1_38,273,255,274,341,1143
lcl|NC_002695.2_cds_NP_308070.1_39,306,423,389,397,1515
lcl|NC_002695.2_cds_NP_308071.2_40,202,167,192,210,771
lcl|NC_002695.2_cds_NP_308072.1_41,226,189,256,271,942
lcl|NC_002695.2_cds_NP_308073.1_42,297,284,322,384,1287
lcl|NC_002695.2_cds_NP_308074.1_43,61,63,69,95,288
lcl|NC_002695.2_cds_NP_308075.1_44,238,383,319,392,1332
lcl|NC_002695.2_cds_NP_308076.1_45,114,126,143,148,531
lcl|NC_002695.2_cds_NP_308077.1_46,363,460,440,600,1863
lcl|NC_002695.2_cds_NP_308078.2_47,149,138,145,159,591
lcl|NC_002695.2_cds_NP_308079.1_48,66,54,56,58,234
lcl|NC_002695.2_cds_NP_308080.1_49,83,88,73,71,315
lcl|NC_002695.2_cds_NP_308081.1_50,185,189,219,256,849
lcl|NC_002695.2_cds_NP_308082.1_51,93,89,102,94,378
lcl|NC_002695.2_cds_NP_308083.1_52,196,189,223,214,822
lcl|NC_002695.2_cds_NP_308084.1_53,208,226,277,279,990
lcl|NC_002695.2_cds_NP_308085.1_54,337,258,343,349,1287
lcl|NC_002695.2_cds_NP_308086.1_55,605,541,614,595,2355
lcl|NC_002695.2_cds_NP_308087.1_56,188,197,181,250,816
lcl|NC_002695.2_cds_NP_308088.1_57,242,196,141,174,753
lcl|NC_002695.2_cds_NP_308089.1_58,160,143,154,203,660
lcl|NC_002695.2_cds_NP_308090.1_59,680,628,785,814,2907
lcl|NC_002695.2_cds_NP_308091.1_60,527,518,641,666,2352
lcl|NC_002695.2_cds_NP_308092.1_61,178,136,199,183,696
lcl|NC_002695.2_cds_NP_308093.1_62,346,321,419,417,1503
lcl|NC_002695.2_cds_NP_308094.1_63,354,361,487,499,1701
lcl|NC_002695.2_cds_NP_308095.1_64,195,219,222,243,879
lcl|NC_002695.2_cds_NP_308096.1_65,126,223,168,248,765
lcl|NC_002695.2_cds_NP_308097.1_66,148,153,176,222,699
lcl|NC_002695.2_cds_NP_308098.1_67,253,408,453,497,1611
lcl|NC_002695.2_cds_NP_308099.1_68,251,212,257,264,984
lcl|NC_002695.2_cds_NP_308100.1_69,177,147,109,137,570
lcl|NC_002695.2_cds_NP_308101.1_70,383,360,464,452,1659
lcl|NC_002695.2_cds_NP_308102.1_71,143,146,150,167,606
lcl|NC_002695.2_cds_NP_308103.1_72,344,277,379,401,1401
lcl|NC_002695.2_cds_NP_308104.2_73,253,240,291,308,1092
lcl|NC_002695.2_cds_NP_308105.1_74,407,330,414,421,1572
lcl|NC_002695.2_cds_NP_308106.1_75,21,25,23,18,87
lcl|NC_002695.2_cds_NP_308107.3_76,251,261,207,226,945
lcl|NC_002695.2_cds_NP_308108.2_77,394,421,409,501,1725
lcl|NC_002695.2_cds_NP_308109.1_78,125,124,106,137,492
lcl|NC_002695.2_cds_NP_308110.1_79,25,23,18,21,87
lcl|NC_002695.2_cds_NP_308111.1_80,218,236,268,283,1005
lcl|NC_002695.2_cds_NP_308112.1_81,115,104,111,129,459
lcl|NC_002695.2_cds_NP_308113.1_82,218,207,246,271,942
lcl|NC_002695.2_cds_NP_308114.1_83,100,81,84,101,366
lcl|NC_002695.2_cds_NP_308115.1_84,414,405,441,507,1767
lcl|NC_002695.2_cds_NP_308116.1_85,324,326,365,473,1488
lcl|NC_002695.2_cds_NP_308117.1_86,312,303,354,390,1359
lcl|NC_002695.2_cds_NP_308118.1_87,192,316,258,317,1083
lcl|NC_002695.2_cds_NP_308119.1_88,293,297,326,401,1317
lcl|NC_002695.2_cds_NP_308120.1_89,236,351,293,365,1245
lcl|NC_002695.2_cds_NP_308121.1_90,235,235,257,341,1068
lcl|NC_002695.2_cds_NP_308122.1_91,336,334,375,431,1476
lcl|NC_002695.2_cds_NP_308123.1_92,224,221,194,282,921
lcl|NC_002695.2_cds_NP_308124.1_93,209,177,195,250,831
lcl|NC_002695.2_cds_NP_308125.1_94,314,289,274,386,1263
lcl|NC_002695.2_cds_NP_308126.1_95,271,256,275,350,1152
lcl|NC_002695.2_cds_NP_308127.1_96,212,236,233,237,918
lcl|NC_002695.2_cds_NP_308128.2_97,121,112,155,125,513
lcl|NC_002695.2_cds_NP_308129.1_98,718,576,665,747,2706
lcl|NC_002695.2_cds_NP_308130.1_99,115,91,76,117,399
lcl|NC_002695.2_cds_NP_308132.1_100,55,40,45,58,198
lcl|NC_002695.2_cds_NP_308133.1_101,169,193,194,188,744
lcl|NC_002695.2_cds_NP_308134.1_102,152,142,161,166,621
lcl|NC_002695.2_cds_NP_308135.1_103,245,267,247,285,1044
lcl|NC_002695.2_cds_NP_308137.1_104,292,283,294,334,1203
lcl|NC_002695.2_cds_NP_308138.1_105,325,312,381,368,1386
lcl|NC_002695.2_cds_NP_308139.1_106,106,100,119,116,441
lcl|NC_002695.2_cds_NP_308140.1_107,225,190,240,239,894
lcl|NC_002695.2_cds_NP_308141.1_108,113,141,141,157,552
lcl|NC_002695.2_cds_NP_308142.1_109,154,256,189,256,855
lcl|NC_002695.2_cds_NP_308143.2_110,280,371,329,391,1371
lcl|NC_002695.2_cds_NP_308144.1_111,182,159,219,205,765
lcl|NC_002695.2_cds_NP_308145.1_112,663,587,699,715,2664
lcl|NC_002695.2_cds_NP_308146.1_113,477,381,470,565,1893
lcl|NC_002695.2_cds_NP_308147.1_114,373,304,350,398,1425
lcl|NC_002695.2_cds_NP_308148.1_115,501,353,543,457,1854
lcl|NC_002695.2_cds_NP_308149.1_116,589,562,703,744,2598
lcl|NC_002695.2_cds_NP_308150.2_117,96,78,67,122,363
lcl|NC_002695.2_cds_NP_308151.1_118,226,203,194,172,795
lcl|NC_002695.2_cds_NP_308152.1_119,211,212,234,210,867
lcl|NC_002695.2_cds_NP_308153.3_120,77,77,81,74,309
lcl|NC_002695.2_cds_NP_308154.1_121,356,355,371,469,1551
lcl|NC_002695.2_cds_NP_308155.1_122,528,543,645,675,2391
lcl|NC_002695.2_cds_NP_308156.2_123,129,138,116,154,537
lcl|NC_002695.2_cds_NP_308157.1_124,175,155,171,162,663
lcl|NC_002695.2_cds_NP_308158.1_125,255,215,204,253,927
lcl|NC_002695.2_cds_NP_308159.1_126,129,249,182,211,771
lcl|NC_002695.2_cds_NP_308160.1_127,108,116,97,120,441
lcl|NC_002695.2_cds_NP_308161.1_128,313,311,286,320,1230
lcl|NC_002695.2_cds_NP_308162.1_129,93,88,102,98,381
lcl|NC_002695.2_cds_NP_308163.1_130,242,219,193,243,897
lcl|NC_002695.2_cds_NP_308164.1_131,203,187,223,239,852
lcl|NC_002695.2_cds_NP_308165.1_132,187,178,204,226,795
lcl|NC_002695.2_cds_NP_308166.1_133,327,299,224,260,1110
lcl|NC_002695.2_cds_NP_308167.1_134,159,153,137,142,591
lcl|NC_002695.2_cds_NP_308168.1_135,170,161,142,133,606
lcl|NC_002695.2_cds_NP_308169.2_136,153,126,132,138,549
lcl|NC_002695.2_cds_NP_308170.1_137,682,647,641,631,2601
lcl|NC_002695.2_cds_NP_308171.1_138,210,165,179,172,726
lcl|NC_002695.2_cds_NP_308172.1_139,163,159,129,146,597
lcl|NC_002695.2_cds_NP_308173.1_140,124,117,129,113,483
lcl|NC_002695.2_cds_NP_308174.3_141,323,295,389,391,1398
lcl|NC_002695.2_cds_NP_308175.3_142,204,224,257,242,927
lcl|NC_002695.2_cds_NP_308176.1_143,133,85,109,129,456
lcl|NC_002695.2_cds_NP_308177.1_144,191,166,170,178,705
lcl|NC_002695.2_cds_NP_308178.2_145,107,128,157,139,531
lcl|NC_002695.2_cds_NP_308179.2_146,538,513,619,760,2430
lcl|NC_002695.2_cds_NP_308180.1_147,591,552,630,762,2535
lcl|NC_002695.2_cds_NP_308181.1_148,548,537,565,594,2244
lcl|NC_002695.2_cds_NP_308182.1_149,149,196,208,245,798
lcl|NC_002695.2_cds_NP_308183.1_150,191,214,234,252,891
lcl|NC_002695.2_cds_NP_308184.1_151,279,512,498,694,1983
lcl|NC_002695.2_cds_NP_308185.1_152,263,306,325,387,1281
lcl|NC_002695.2_cds_NP_308186.1_153,266,386,334,436,1422
lcl|NC_002695.2_cds_NP_308187.1_154,86,83,81,95,345
lcl|NC_002695.2_cds_NP_308188.1_155,118,173,145,188,624
lcl|NC_002695.2_cds_NP_308189.1_156,200,181,215,205,801
lcl|NC_002695.2_cds_NP_308190.1_157,163,167,178,191,699
lcl|NC_002695.2_cds_NP_308191.1_158,395,398,342,383,1518
lcl|NC_002695.2_cds_NP_308192.1_159,355,303,359,408,1425
lcl|NC_002695.2_cds_NP_308193.1_160,271,276,251,360,1158
lcl|NC_002695.2_cds_NP_308194.1_161,125,90,81,91,387
lcl|NC_002695.2_cds_NP_308195.1_162,198,189,205,233,825
lcl|NC_002695.2_cds_NP_308196.1_163,633,619,728,693,2673
lcl|NC_002695.2_cds_NP_308197.1_164,220,179,192,204,795
lcl|NC_002695.2_cds_NP_308198.1_165,187,166,184,189,726
lcl|NC_002695.2_cds_NP_308199.1_166,247,181,185,239,852
lcl|NC_002695.2_cds_NP_308200.1_167,177,165,170,214,726
lcl|NC_002695.2_cds_NP_308201.1_168,162,112,130,154,558
lcl|NC_002695.2_cds_NP_308202.1_169,288,279,298,332,1197
lcl|NC_002695.2_cds_NP_308203.2_170,198,184,165,212,759
lcl|NC_002695.2_cds_NP_308204.3_171,150,254,185,239,828
lcl|NC_002695.2_cds_NP_308205.1_172,301,364,298,390,1353
lcl|NC_002695.2_cds_NP_308206.1_173,612,592,584,645,2433
lcl|NC_002695.2_cds_NP_308207.1_174,143,100,113,130,486
lcl|NC_002695.2_cds_NP_308208.1_175,252,231,251,292,1026
lcl|NC_002695.2_cds_NP_308209.2_176,106,119,105,126,456
lcl|NC_002695.2_cds_NP_308210.1_177,181,186,199,223,789
lcl|NC_002695.2_cds_NP_308211.1_178,262,270,280,337,1149
lcl|NC_002695.2_cds_NP_308212.1_179,132,127,154,184,597
lcl|NC_002695.2_cds_NP_308213.1_180,812,757,879,1035,3483
lcl|NC_002695.2_cds_NP_308214.1_181,231,221,234,274,960
lcl|NC_002695.2_cds_NP_308215.1_182,531,519,514,578,2142
lcl|NC_002695.2_cds_NP_308216.2_183,88,100,95,107,390
lcl|NC_002695.2_cds_NP_308217.1_184,262,275,337,422,1296
lcl|NC_002695.2_cds_NP_308218.3_185,74,62,58,67,261
lcl|NC_002695.2_cds_YP_009502588.1_186,55,44,40,62,201
lcl|NC_002695.2_cds_NP_308219.1_187,103,105,113,138,459
lcl|NC_002695.2_cds_NP_308220.1_188,109,78,108,116,411
lcl|NC_002695.2_cds_NP_308221.1_189,181,158,170,202,711
lcl|NC_002695.2_cds_NP_308222.1_190,205,214,206,200,825
lcl|NC_002695.2_cds_NP_308223.1_191,411,371,446,491,1719
lcl|NC_002695.2_cds_NP_308224.1_192,152,170,191,195,708
lcl|NC_002695.2_cds_NP_308225.1_193,102,86,117,100,405
lcl|NC_002695.2_cds_NP_308226.1_194,237,182,191,206,816
lcl|NC_002695.2_cds_NP_308227.1_195,116,197,151,190,654
lcl|NC_002695.2_cds_NP_308228.1_196,255,241,262,274,1032
lcl|NC_002695.2_cds_NP_308229.1_197,150,137,125,164,576
lcl|NC_002695.2_cds_NP_308230.1_198,229,202,179,194,804
lcl|NC_002695.2_cds_NP_308231.1_199,238,220,209,248,915
lcl|NC_002695.2_cds_NP_308232.2_200,172,200,198,210,780
lcl|NC_002695.2_cds_NP_308233.1_201,203,190,177,201,771
lcl|NC_002695.2_cds_NP_308234.1_202,366,286,327,380,1359
lcl|NC_002695.2_cds_NP_308235.1_203,233,217,137,169,756
lcl|NC_002695.2_cds_NP_308236.2_204,171,196,176,180,723
lcl|NC_002695.2_cds_NP_308237.1_205,134,97,111,126,468
lcl|NC_002695.2_cds_NP_308238.2_206,190,172,176,203,741
lcl|NC_002695.2_cds_YP_009502589.1_207,261,201,160,179,801
lcl|NC_002695.2_cds_NP_308239.1_208,121,92,44,40,297
lcl|NC_002695.2_cds_NP_308240.1_209,166,131,71,82,450
lcl|NC_002695.2_cds_NP_308241.2_210,242,143,109,103,597
lcl|NC_002695.2_cds_NP_302948.1_211,97,62,29,34,222
lcl|NC_002695.2_cds_NP_308243.1_212,168,154,80,78,480
lcl|NC_002695.2_cds_NP_308244.1_213,377,273,367,393,1410
lcl|NC_002695.2_cds_NP_308245.2_214,780,709,973,973,3435
lcl|NC_002695.2_cds_NP_308249.1_215,140,129,226,249,744
lcl|NC_002695.2_cds_NP_308250.1_216,601,514,808,849,2772
lcl|NC_002695.2_cds_NP_308251.1_217,171,187,201,203,762
lcl|NC_002695.2_cds_NP_308252.1_218,307,286,383,356,1332
lcl|NC_002695.2_cds_NP_308253.1_219,157,97,131,140,525
lcl|NC_002695.2_cds_NP_308254.1_220,292,259,370,360,1281
lcl|NC_002695.2_cds_NP_308255.1_221,244,244,295,300,1083
lcl|NC_002695.2_cds_NP_308256.1_222,406,457,520,468,1851
lcl|NC_002695.2_cds_NP_308257.1_223,105,92,102,115,414
lcl|NC_002695.2_cds_NP_308258.1_224,347,326,364,355,1392
lcl|NC_002695.2_cds_NP_308259.1_225,53,61,55,56,225
lcl|NC_002695.2_cds_NP_308260.1_226,144,104,119,134,501
lcl|NC_002695.2_cds_NP_308261.1_227,124,115,149,131,519
lcl|NC_002695.2_cds_NP_308263.1_228,525,426,547,644,2142
lcl|NC_002695.2_cds_NP_308264.2_229,944,689,1123,1459,4215
lcl|NC_002695.2_cds_NP_308265.2_230,207,128,72,139,546
lcl|NC_002695.2_cds_NP_308268.1_231,370,292,202,273,1137
lcl|NC_002695.2_cds_NP_308269.1_232,449,315,439,558,1761
lcl|NC_002695.2_cds_NP_308270.1_233,58,69,22,22,171
lcl|NC_002695.2_cds_NP_308271.1_234,99,90,23,52,264
lcl|NC_002695.2_cds_NP_308272.1_235,419,313,159,282,1173
lcl|NC_002695.2_cds_NP_308273.1_236,156,192,179,244,771
lcl|NC_002695.2_cds_NP_308274.2_237,123,101,98,125,447
lcl|NC_002695.2_cds_NP_308275.2_238,526,543,645,731,2445
lcl|NC_002695.2_cds_NP_308276.1_239,146,138,139,156,579
lcl|NC_002695.2_cds_NP_308277.1_240,183,180,190,215,768
lcl|NC_002695.2_cds_NP_308278.1_241,200,176,185,180,741
lcl|NC_002695.2_cds_NP_308279.1_242,82,74,53,52,261
lcl|NC_002695.2_cds_NP_308280.1_243,74,63,58,66,261
lcl|NC_002695.2_cds_NP_308281.2_244,186,184,199,205,774
lcl|NC_002695.2_cds_NP_308284.2_245,368,354,481,537,1740
lcl|NC_002695.2_cds_NP_308283.2_246,176,123,146,191,636
lcl|NC_002695.2_cds_NP_308285.1_247,250,237,274,295,1056
lcl|NC_002695.2_cds_NP_308286.1_248,98,75,60,61,294
lcl|NC_002695.2_cds_NP_308287.1_249,112,115,82,90,399
lcl|NC_002695.2_cds_NP_308288.2_250,102,103,86,87,378
lcl|NC_002695.2_cds_NP_308289.1_251,65,64,70,68,267
lcl|NC_002695.2_cds_NP_308290.1_252,122,102,123,154,501
lcl|NC_002695.2_cds_NP_308291.1_253,373,333,364,388,1458
lcl|NC_002695.2_cds_NP_308292.1_254,107,115,110,127,459
lcl|NC_002695.2_cds_NP_308293.1_255,279,301,325,340,1245
lcl|NC_002695.2_cds_NP_308294.1_256,103,98,79,122,402
lcl|NC_002695.2_cds_NP_308295.1_257,316,264,213,263,1056
lcl|NC_002695.2_cds_NP_308296.1_258,245,243,294,322,1104
lcl|NC_002695.2_cds_NP_308297.1_259,304,264,316,370,1254
lcl|NC_002695.2_cds_NP_308299.1_260,77,45,60,64,246
lcl|NC_002695.2_cds_NP_308300.1_261,131,105,82,72,390
lcl|NC_002695.2_cds_NP_308301.1_262,204,180,148,182,714
lcl|NC_002695.2_cds_NP_308302.1_263,75,40,43,43,201
lcl|NC_002695.2_cds_NP_308303.1_264,83,63,62,86,294
lcl|NC_002695.2_cds_NP_308307.1_265,189,223,162,221,795
lcl|NC_002695.2_cds_NP_308308.1_266,166,135,129,164,594
lcl|NC_002695.2_cds_NP_308309.1_267,135,109,87,113,444
lcl|NC_002695.2_cds_NP_308310.1_268,105,104,88,114,411
lcl|NC_002695.2_cds_NP_308311.1_269,149,129,115,162,555
lcl|NC_002695.2_cds_NP_308312.1_270,242,198,151,183,774
lcl|NC_002695.2_cds_NP_308314.1_271,218,264,106,156,744
lcl|NC_002695.2_cds_NP_308315.1_272,112,72,77,93,354
lcl|NC_002695.2_cds_NP_308316.1_273,348,301,236,297,1182
lcl|NC_002695.2_cds_NP_308317.1_274,132,136,60,89,417
lcl|NC_002695.2_cds_NP_308318.1_275,217,212,89,100,618
lcl|NC_002695.2_cds_NP_308319.1_276,150,163,63,83,459
lcl|NC_002695.2_cds_NP_308323.1_277,86,53,74,60,273
lcl|NC_002695.2_cds_NP_308324.1_278,142,127,139,144,552
lcl|NC_002695.2_cds_NP_308325.1_279,225,151,177,200,753
lcl|NC_002695.2_cds_NP_308326.1_280,47,67,70,77,261
lcl|NC_002695.2_cds_NP_308327.1_281,102,161,158,137,558
lcl|NC_002695.2_cds_NP_308328.1_282,59,53,46,64,222
lcl|NC_002695.2_cds_NP_308329.1_283,62,82,90,90,324
lcl|NC_002695.2_cds_NP_308330.1_284,580,535,574,645,2334
lcl|NC_002695.2_cds_NP_308331.1_285,357,300,144,156,957
lcl|NC_002695.2_cds_NP_308332.2_286,213,237,217,233,900
lcl|NC_002695.2_cds_NP_308333.1_287,185,179,159,200,723
lcl|NC_002695.2_cds_NP_308334.1_288,95,88,48,48,279
lcl|NC_002695.2_cds_NP_308336.1_289,216,205,223,259,903
lcl|NC_002695.2_cds_NP_308337.2_290,254,236,257,312,1059
lcl|NC_002695.2_cds_NP_308338.2_291,174,304,285,365,1128
lcl|NC_002695.2_cds_NP_308340.1_292,186,197,278,296,957
lcl|NC_002695.2_cds_NP_308341.1_293,480,410,650,659,2199
lcl|NC_002695.2_cds_NP_308342.1_294,194,179,296,288,957
lcl|NC_002695.2_cds_NP_308343.1_295,166,146,187,191,690
lcl|NC_002695.2_cds_NP_308344.1_296,135,202,131,147,615
lcl|NC_002695.2_cds_NP_308346.2_297,169,165,181,196,711
lcl|NC_002695.2_cds_NP_308347.1_298,424,373,431,416,1644
lcl|NC_002695.2_cds_NP_308348.1_299,616,520,672,718,2526
lcl|NC_002695.2_cds_NP_308349.1_300,162,139,200,168,669
lcl|NC_002695.2_cds_NP_308350.1_301,156,121,159,152,588
lcl|NC_002695.2_cds_NP_308351.2_302,182,148,89,124,543
lcl|NC_002695.2_cds_NP_308353.1_303,66,39,32,55,192
lcl|NC_002695.2_cds_YP_009502590.1_304,46,34,29,32,141
lcl|NC_002695.2_cds_NP_308354.2_305,76,68,56,67,267
lcl|NC_002695.2_cds_NP_308355.2_306,103,81,106,91,381
lcl|NC_002695.2_cds_NP_308356.1_307,69,75,99,105,348
lcl|NC_002695.2_cds_NP_308357.1_308,345,294,425,475,1539
lcl|NC_002695.2_cds_NP_308358.1_309,339,300,246,258,1143
lcl|NC_002695.2_cds_NP_308359.1_310,251,251,191,228,921
lcl|NC_002695.2_cds_NP_308360.1_311,239,282,176,230,927
lcl|NC_002695.2_cds_NP_308361.1_312,119,102,66,70,357
lcl|NC_002695.2_cds_NP_308362.1_313,149,134,151,142,576
lcl|NC_002695.2_cds_NP_308363.1_314,1105,919,1004,1226,4254
lcl|NC_002695.2_cds_NP_308364.2_315,240,244,185,189,858
lcl|NC_002695.2_cds_NP_308365.3_316,248,248,159,215,870
lcl|NC_002695.2_cds_NP_308366.1_317,153,173,122,146,594
lcl|NC_002695.2_cds_NP_308369.2_318,374,349,275,328,1326
lcl|NC_002695.2_cds_NP_308370.1_319,197,225,202,231,855
lcl|NC_002695.2_cds_NP_308371.1_320,183,173,154,210,720
lcl|NC_002695.2_cds_NP_308372.1_321,367,346,312,403,1428
lcl|NC_002695.2_cds_NP_308373.2_322,165,166,156,209,696
lcl|NC_002695.2_cds_NP_308376.2_323,53,53,46,61,213
lcl|NC_002695.2_cds_NP_308377.1_324,337,291,214,253,1095
lcl|NC_002695.2_cds_NP_308378.1_325,210,193,158,201,762
lcl|NC_002695.2_cds_NP_308379.2_326,37,49,39,43,168
lcl|NC_002695.2_cds_NP_303089.1_327,29,72,7,27,135
lcl|NC_002695.2_cds_NP_308384.1_328,381,339,469,500,1689
lcl|NC_002695.2_cds_NP_308385.2_329,319,289,418,447,1473
lcl|NC_002695.2_cds_NP_308386.3_330,137,117,163,171,588
lcl|NC_002695.2_cds_NP_308387.1_331,387,521,522,604,2034
lcl|NC_002695.2_cds_NP_308389.1_332,1103,899,860,1122,3984
lcl|NC_002695.2_cds_NP_308390.1_333,293,297,223,276,1089
lcl|NC_002695.2_cds_NP_308393.1_334,52,86,65,100,303
lcl|NC_002695.2_cds_NP_308394.1_335,169,158,127,152,606
lcl|NC_002695.2_cds_NP_308395.1_336,232,225,191,216,864
lcl|NC_002695.2_cds_NP_308396.1_337,372,311,411,454,1548
lcl|NC_002695.2_cds_NP_308397.1_338,303,285,381,450,1419
lcl|NC_002695.2_cds_NP_308398.1_339,75,70,84,92,321
lcl|NC_002695.2_cds_NP_308399.1_340,227,185,252,287,951
lcl|NC_002695.2_cds_NP_308400.1_341,338,267,390,388,1383
lcl|NC_002695.2_cds_YP_009502591.1_342,104,122,82,103,411
lcl|NC_002695.2_cds_NP_308401.1_343,266,248,204,269,987
lcl|NC_002695.2_cds_NP_308402.2_344,275,299,261,344,1179
lcl|NC_002695.2_cds_NP_308404.1_345,184,294,217,277,972
lcl|NC_002695.2_cds_NP_308405.1_346,179,285,209,284,957
lcl|NC_002695.2_cds_NP_308406.1_347,246,244,251,309,1050
lcl|NC_002695.2_cds_NP_308407.1_348,250,248,151,167,816
lcl|NC_002695.2_cds_NP_308409.4_349,122,198,146,167,633
lcl|NC_002695.2_cds_NP_308410.1_350,101,68,43,64,276
lcl|NC_002695.2_cds_NP_308411.1_351,360,350,418,459,1587
lcl|NC_002695.2_cds_NP_308412.1_352,190,200,239,262,891
lcl|NC_002695.2_cds_NP_308413.1_353,275,240,329,326,1170
lcl|NC_002695.2_cds_NP_308414.1_354,335,302,431,384,1452
lcl|NC_002695.2_cds_NP_308415.1_355,377,411,486,613,1887
lcl|NC_002695.2_cds_NP_308416.1_356,212,366,313,369,1260
lcl|NC_002695.2_cds_NP_308417.1_357,317,281,331,355,1284
lcl|NC_002695.2_cds_NP_308418.1_358,193,209,237,261,900
lcl|NC_002695.2_cds_NP_308419.2_359,127,158,192,183,660
lcl|NC_002695.2_cds_NP_308420.1_360,114,112,122,123,471
lcl|NC_002695.2_cds_NP_308421.2_361,182,314,312,374,1182
lcl|NC_002695.2_cds_NP_308422.1_362,192,164,122,134,612
lcl|NC_002695.2_cds_NP_308423.1_363,242,436,284,292,1254
lcl|NC_002695.2_cds_NP_308424.1_364,696,665,841,873,3075
lcl|NC_002695.2_cds_NP_308425.4_365,241,237,296,318,1092
lcl|NC_002695.2_cds_NP_308426.1_366,223,237,250,244,954
lcl|NC_002695.2_cds_NP_308427.2_367,226,180,192,179,777
lcl|NC_002695.2_cds_NP_308428.3_368,233,206,231,278,948
lcl|NC_002695.2_cds_NP_308429.1_369,352,365,439,509,1665
lcl|NC_002695.2_cds_NP_308430.1_370,180,224,254,287,945
lcl|NC_002695.2_cds_NP_308431.3_371,189,206,219,253,867
lcl|NC_002695.2_cds_NP_308432.2_372,180,180,201,249,810
lcl|NC_002695.2_cds_NP_308433.1_373,224,207,237,283,951
lcl|NC_002695.2_cds_NP_308434.1_374,222,219,250,323,1014
lcl|NC_002695.2_cds_NP_308435.2_375,187,330,284,411,1212
lcl|NC_002695.2_cds_NP_308436.2_376,167,116,111,146,540
lcl|NC_002695.2_cds_NP_308437.1_377,213,213,192,216,834
lcl|NC_002695.2_cds_NP_308438.1_378,256,261,276,317,1110
lcl|NC_002695.2_cds_NP_308439.4_379,69,61,66,80,276
lcl|NC_002695.2_cds_NP_308440.2_380,246,242,268,291,1047
lcl|NC_002695.2_cds_NP_308441.1_381,361,561,582,575,2079
lcl|NC_002695.2_cds_NP_308442.1_382,287,217,253,275,1032
lcl|NC_002695.2_cds_NP_308443.1_383,248,333,331,393,1305
lcl|NC_002695.2_cds_NP_308444.1_384,313,401,421,407,1542
lcl|NC_002695.2_cds_NP_308445.1_385,141,150,157,182,630
lcl|NC_002695.2_cds_NP_308446.1_386,235,189,254,285,963
lcl|NC_002695.2_cds_NP_308447.1_387,168,167,195,238,768
lcl|NC_002695.2_cds_NP_308448.1_388,133,209,211,275,828
lcl|NC_002695.2_cds_NP_308449.1_389,198,192,221,241,852
lcl|NC_002695.2_cds_NP_308450.2_390,223,226,244,282,975
lcl|NC_002695.2_cds_NP_308451.1_391,797,773,686,687,2943
lcl|NC_002695.2_cds_NP_308452.2_392,194,184,117,129,624
lcl|NC_002695.2_cds_NP_308453.1_393,244,275,305,334,1158
lcl|NC_002695.2_cds_NP_308454.1_394,241,359,293,328,1221
lcl|NC_002695.2_cds_NP_308455.1_395,271,241,257,326,1095
lcl|NC_002695.2_cds_NP_308456.1_396,56,91,74,88,309
lcl|NC_002695.2_cds_NP_308457.2_397,48,61,42,62,213
lcl|NC_002695.2_cds_NP_308458.1_398,278,255,264,298,1095
lcl|NC_002695.2_cds_NP_308459.1_399,79,61,50,71,261
lcl|NC_002695.2_cds_NP_308460.2_400,373,284,373,386,1416
lcl|NC_002695.2_cds_NP_308461.2_401,98,70,76,77,321
lcl|NC_002695.2_cds_NP_308462.1_402,244,271,272,329,1116
lcl|NC_002695.2_cds_NP_308464.3_403,196,170,216,228,810
lcl|NC_002695.2_cds_NP_308463.2_404,100,102,113,144,459
lcl|NC_002695.2_cds_NP_308465.1_405,134,116,127,148,525
lcl|NC_002695.2_cds_NP_308466.1_406,68,32,47,45,192
lcl|NC_002695.2_cds_NP_308467.1_407,180,182,142,174,678
lcl|NC_002695.2_cds_NP_308468.1_408,64,73,69,79,285
lcl|NC_002695.2_cds_NP_308469.2_409,713,602,436,529,2280
lcl|NC_002695.2_cds_NP_308470.1_410,131,117,94,108,450
lcl|NC_002695.2_cds_NP_308472.3_411,267,211,223,277,978
lcl|NC_002695.2_cds_NP_308471.2_412,206,195,203,305,909
lcl|NC_002695.2_cds_NP_308473.4_413,238,389,280,362,1269
lcl|NC_002695.2_cds_NP_308474.2_414,867,572,846,859,3144
lcl|NC_002695.2_cds_NP_308475.1_415,294,269,331,309,1203
lcl|NC_002695.2_cds_NP_308476.1_416,164,151,167,208,690
lcl|NC_002695.2_cds_NP_308477.1_417,304,302,309,381,1296
lcl|NC_002695.2_cds_NP_308478.1_418,209,377,358,376,1320
lcl|NC_002695.2_cds_NP_308479.1_419,265,383,327,399,1374
lcl|NC_002695.2_cds_NP_308480.3_420,408,416,447,547,1818
lcl|NC_002695.2_cds_NP_308481.1_421,521,393,250,282,1446
lcl|NC_002695.2_cds_NP_308482.1_422,118,153,160,151,582
lcl|NC_002695.2_cds_NP_308483.1_423,248,243,288,292,1071
lcl|NC_002695.2_cds_NP_308484.1_424,268,280,274,306,1128
lcl|NC_002695.2_cds_NP_308485.1_425,84,84,75,90,333
lcl|NC_002695.2_cds_NP_308486.2_426,430,415,461,509,1815
lcl|NC_002695.2_cds_NP_308487.1_427,209,260,226,277,972
lcl|NC_002695.2_cds_NP_308488.1_428,72,62,44,65,243
lcl|NC_002695.2_cds_NP_308489.1_429,75,79,58,70,282
lcl|NC_002695.2_cds_NP_308490.1_430,105,79,79,85,348
lcl|NC_002695.2_cds_NP_308491.1_431,223,216,225,221,885
lcl|NC_002695.2_cds_NP_308492.2_432,160,127,127,126,540
lcl|NC_002695.2_cds_NP_308493.1_433,113,108,100,129,450
lcl|NC_002695.2_cds_NP_308494.1_434,255,230,294,325,1104
lcl|NC_002695.2_cds_NP_308495.1_435,117,110,111,133,471
lcl|NC_002695.2_cds_NP_308496.1_436,108,87,111,114,420
lcl|NC_002695.2_cds_NP_308497.1_437,192,251,255,280,978
lcl|NC_002695.2_cds_NP_308498.1_438,97,146,116,157,516
lcl|NC_002695.2_cds_NP_308499.1_439,620,441,263,248,1572
lcl|NC_002695.2_cds_NP_308500.1_440,245,207,242,281,975
lcl|NC_002695.2_cds_NP_308501.1_441,450,413,490,510,1863
lcl|NC_002695.2_cds_NP_308502.1_442,209,202,240,249,900
lcl|NC_002695.2_cds_NP_308503.1_443,69,39,65,70,243
lcl|NC_002695.2_cds_NP_308504.1_444,350,348,354,397,1449
lcl|NC_002695.2_cds_NP_308505.2_445,126,129,155,181,591
lcl|NC_002695.2_cds_NP_308506.1_446,234,213,231,234,912
lcl|NC_002695.2_cds_NP_308507.2_447,135,112,110,135,492
lcl|NC_002695.2_cds_NP_308508.2_448,278,363,324,400,1365
lcl|NC_002695.2_cds_NP_308509.1_449,161,253,216,261,891
lcl|NC_002695.2_cds_NP_308510.1_450,78,88,81,83,330
lcl|NC_002695.2_cds_NP_308511.1_451,117,169,163,166,615
lcl|NC_002695.2_cds_NP_308512.1_452,389,552,514,537,1992
lcl|NC_002695.2_cds_NP_308513.1_453,243,223,246,236,948
lcl|NC_002695.2_cds_NP_308514.1_454,254,425,384,413,1476
lcl|NC_002695.2_cds_NP_308515.2_455,157,125,163,134,579
lcl|NC_002695.2_cds_NP_308516.3_456,78,84,71,82,315
lcl|NC_002695.2_cds_NP_308517.1_457,376,260,297,366,1299
lcl|NC_002695.2_cds_NP_308518.1_458,151,159,153,161,624
lcl|NC_002695.2_cds_NP_308519.1_459,333,283,301,358,1275
lcl|NC_002695.2_cds_NP_308520.1_460,612,514,555,674,2355
lcl|NC_002695.2_cds_NP_308521.1_461,72,66,61,74,273
lcl|NC_002695.2_cds_NP_308522.1_462,531,368,450,523,1872
lcl|NC_002695.2_cds_NP_308523.1_463,102,67,89,114,372
lcl|NC_002695.2_cds_NP_308524.1_464,117,99,81,102,399
lcl|NC_002695.2_cds_NP_308525.1_465,174,163,158,201,696
lcl|NC_002695.2_cds_NP_308526.1_466,414,383,478,426,1701
lcl|NC_002695.2_cds_NP_308527.2_467,180,221,198,220,819
lcl|NC_002695.2_cds_NP_308528.2_468,114,106,119,120,459
lcl|NC_002695.2_cds_NP_308529.1_469,369,448,432,524,1773
lcl|NC_002695.2_cds_NP_308530.1_470,358,426,449,549,1782
lcl|NC_002695.2_cds_NP_308531.1_471,92,74,76,97,339
lcl|NC_002695.2_cds_NP_308532.1_472,225,349,281,432,1287
lcl|NC_002695.2_cds_NP_308533.1_473,196,214,221,230,861
lcl|NC_002695.2_cds_NP_308534.3_474,135,127,165,146,573
lcl|NC_002695.2_cds_NP_308535.2_475,73,62,86,91,312
lcl|NC_002695.2_cds_NP_308536.1_476,92,86,68,108,354
lcl|NC_002695.2_cds_NP_308537.2_477,407,401,361,382,1551
lcl|NC_002695.2_cds_NP_308538.2_478,109,143,117,102,471
lcl|NC_002695.2_cds_NP_308539.1_479,140,146,129,137,552
lcl|NC_002695.2_cds_NP_308540.1_480,72,58,48,41,219
lcl|NC_002695.2_cds_NP_308541.1_481,117,107,73,78,375
lcl|NC_002695.2_cds_NP_308542.1_482,685,771,790,904,3150
lcl|NC_002695.2_cds_NP_308543.1_483,312,237,314,331,1194
lcl|NC_002695.2_cds_NP_308544.1_484,189,168,142,149,648
lcl|NC_002695.2_cds_NP_308545.1_485,818,800,828,917,3363
lcl|NC_002695.2_cds_NP_308546.1_486,48,37,35,45,165
lcl|NC_002695.2_cds_NP_308547.1_487,120,100,150,158,528
lcl|NC_002695.2_cds_NP_308548.1_488,64,116,95,103,378
lcl|NC_002695.2_cds_NP_308549.1_489,132,123,150,147,552
lcl|NC_002695.2_cds_NP_308550.1_490,445,375,535,577,1932
lcl|NC_002695.2_cds_NP_308551.1_491,99,60,74,97,330
lcl|NC_002695.2_cds_NP_308552.1_492,128,131,165,182,606
lcl|NC_002695.2_cds_NP_308553.1_493,492,394,479,510,1875
lcl|NC_002695.2_cds_NP_308554.2_494,187,161,166,191,705
lcl|NC_002695.2_cds_NP_308555.1_495,219,225,247,272,963
lcl|NC_002695.2_cds_NP_308556.1_496,209,254,238,259,960
lcl|NC_002695.2_cds_NP_308557.1_497,333,294,328,350,1305
lcl|NC_002695.2_cds_NP_308558.1_498,320,431,403,523,1677
lcl|NC_002695.2_cds_NP_308559.1_499,233,349,310,329,1221
lcl|NC_002695.2_cds_NP_308560.1_500,455,358,366,474,1653
lcl|NC_002695.2_cds_NP_308561.1_501,133,100,119,128,480
lcl|NC_002695.2_cds_NP_308562.1_502,195,175,214,211,795
lcl|NC_002695.2_cds_NP_308563.3_503,127,98,78,93,396
lcl|NC_002695.2_cds_NP_308564.1_504,540,507,646,812,2505
lcl|NC_002695.2_cds_NP_308565.1_505,217,215,239,262,933
lcl|NC_002695.2_cds_NP_308566.1_506,232,365,314,382,1293
lcl|NC_002695.2_cds_NP_308567.1_507,377,280,338,361,1356
lcl|NC_002695.2_cds_NP_308568.1_508,1022,786,1289,1289,4386
lcl|NC_002695.2_cds_NP_308569.1_509,3528,2641,4889,4818,15876
lcl|NC_002695.2_cds_NP_308570.2_510,455,472,550,686,2163
lcl|NC_002695.2_cds_NP_308571.1_511,285,223,320,348,1176
lcl|NC_002695.2_cds_NP_308572.1_512,103,75,110,120,408
lcl|NC_002695.2_cds_NP_308573.1_513,126,112,91,94,423
lcl|NC_002695.2_cds_NP_308575.1_514,324,199,266,228,1017
lcl|NC_002695.2_cds_NP_308576.1_515,111,92,73,87,363
lcl|NC_002695.2_cds_NP_308578.2_516,80,113,104,162,459
lcl|NC_002695.2_cds_NP_308579.1_517,234,200,235,249,918
lcl|NC_002695.2_cds_NP_308580.1_518,193,177,150,158,678
lcl|NC_002695.2_cds_NP_308581.2_519,199,221,154,206,780
lcl|NC_002695.2_cds_NP_308582.2_520,204,172,218,261,855
lcl|NC_002695.2_cds_NP_308583.1_521,189,178,206,237,810
lcl|NC_002695.2_cds_NP_308585.2_522,133,143,161,157,594
lcl|NC_002695.2_cds_NP_308584.2_523,152,144,176,215,687
lcl|NC_002695.2_cds_NP_308586.1_524,467,551,616,781,2415
lcl|NC_002695.2_cds_NP_308587.2_525,953,676,1152,1416,4197
lcl|NC_002695.2_cds_NP_308588.1_526,85,103,37,36,261
lcl|NC_002695.2_cds_NP_308590.2_527,94,92,96,90,372
lcl|NC_002695.2_cds_NP_308591.1_528,261,231,272,331,1095
lcl|NC_002695.2_cds_NP_308592.1_529,227,218,235,247,927
lcl|NC_002695.2_cds_NP_308593.1_530,116,122,118,127,483
lcl|NC_002695.2_cds_NP_308594.1_531,185,198,190,243,816
lcl|NC_002695.2_cds_NP_308595.1_532,406,421,444,511,1782
lcl|NC_002695.2_cds_NP_308596.1_533,208,220,151,198,777
lcl|NC_002695.2_cds_NP_308597.1_534,213,221,204,241,879
lcl|NC_002695.2_cds_NP_308599.1_535,287,442,305,358,1392
lcl|NC_002695.2_cds_NP_308602.2_536,216,417,323,346,1302
lcl|NC_002695.2_cds_NP_308603.1_537,248,252,251,395,1146
lcl|NC_002695.2_cds_NP_308604.1_538,203,219,174,190,786
lcl|NC_002695.2_cds_NP_308605.1_539,314,281,292,349,1236
lcl|NC_002695.2_cds_NP_308606.1_540,257,240,276,277,1050
lcl|NC_002695.2_cds_NP_308607.1_541,372,363,440,493,1668
lcl|NC_002695.2_cds_NP_308608.2_542,274,265,319,402,1260
lcl|NC_002695.2_cds_NP_308609.1_543,154,200,216,246,816
lcl|NC_002695.2_cds_NP_308610.1_544,195,190,205,304,894
lcl|NC_002695.2_cds_NP_308611.1_545,219,240,276,333,1068
lcl|NC_002695.2_cds_NP_308612.1_546,120,97,146,147,510
lcl|NC_002695.2_cds_NP_308613.1_547,161,177,186,199,723
lcl|NC_002695.2_cds_NP_308614.1_548,146,112,119,118,495
lcl|NC_002695.2_cds_NP_308615.1_549,334,294,349,409,1386
lcl|NC_002695.2_cds_NP_308616.1_550,79,166,119,158,522
lcl|NC_002695.2_cds_NP_308617.2_551,53,41,49,70,213
lcl|NC_002695.2_cds_NP_308618.1_552,196,198,228,245,867
lcl|NC_002695.2_cds_NP_308619.2_553,143,158,125,117,543
lcl|NC_002695.2_cds_NP_308620.1_554,204,197,146,146,693
lcl|NC_002695.2_cds_NP_308621.1_555,658,707,583,662,2610
lcl|NC_002695.2_cds_NP_308622.2_556,252,301,207,248,1008
lcl|NC_002695.2_cds_NP_308623.1_557,125,135,117,139,516
lcl|NC_002695.2_cds_NP_308624.1_558,209,192,116,116,633
lcl|NC_002695.2_cds_NP_308625.1_559,213,197,190,162,762
lcl|NC_002695.2_cds_NP_308626.1_560,209,216,235,231,891
lcl|NC_002695.2_cds_NP_308627.1_561,718,618,817,820,2973
lcl|NC_002695.2_cds_NP_308628.1_562,505,560,568,605,2238
lcl|NC_002695.2_cds_NP_308629.1_563,373,293,197,274,1137
lcl|NC_002695.2_cds_NP_308630.1_564,358,266,297,414,1335
lcl|NC_002695.2_cds_NP_308631.1_565,155,135,43,75,408
lcl|NC_002695.2_cds_NP_308632.1_566,1171,868,1319,1493,4851
lcl|NC_002695.2_cds_NP_308633.1_567,120,91,126,125,462
lcl|NC_002695.2_cds_NP_308634.1_568,452,368,499,583,1902
lcl|NC_002695.2_cds_NP_308635.1_569,338,346,384,381,1449
lcl|NC_002695.2_cds_NP_308636.1_570,149,160,166,209,684
lcl|NC_002695.2_cds_NP_308637.1_571,354,318,342,369,1383
lcl|NC_002695.2_cds_NP_308638.1_572,105,77,78,73,333
lcl|NC_002695.2_cds_NP_308639.1_573,281,259,330,354,1224
lcl|NC_002695.2_cds_NP_308640.1_574,666,736,750,986,3138
lcl|NC_002695.2_cds_NP_308641.1_575,254,393,330,400,1377
lcl|NC_002695.2_cds_NP_308642.1_576,296,357,276,319,1248
lcl|NC_002695.2_cds_NP_308643.1_577,168,152,165,169,654
lcl|NC_002695.2_cds_NP_308644.1_578,98,95,86,90,369
lcl|NC_002695.2_cds_NP_308645.1_579,42,82,65,60,249
lcl|NC_002695.2_cds_NP_308646.1_580,260,273,287,299,1119
lcl|NC_002695.2_cds_NP_308647.1_581,34,44,28,47,153
lcl|NC_002695.2_cds_NP_308648.2_582,35,45,28,45,153
lcl|NC_002695.2_cds_NP_308649.3_583,198,187,177,182,744
lcl|NC_002695.2_cds_NP_308650.1_584,581,450,566,644,2241
lcl|NC_002695.2_cds_NP_308651.2_585,279,271,306,347,1203
lcl|NC_002695.2_cds_YP_009502592.1_586,50,49,58,62,219
lcl|NC_002695.2_cds_NP_308652.1_587,818,881,1037,1146,3882
lcl|NC_002695.2_cds_NP_308653.1_588,334,294,234,272,1134
lcl|NC_002695.2_cds_NP_308654.1_589,199,175,205,237,816
lcl|NC_002695.2_cds_NP_308655.1_590,161,262,264,306,993
lcl|NC_002695.2_cds_NP_308656.1_591,146,248,292,319,1005
lcl|NC_002695.2_cds_NP_308657.1_592,197,326,310,418,1251
lcl|NC_002695.2_cds_NP_308658.1_593,233,194,269,261,957
lcl|NC_002695.2_cds_NP_308659.1_594,246,268,325,337,1176
lcl|NC_002695.2_cds_NP_308660.1_595,347,366,428,470,1611
lcl|NC_002695.2_cds_NP_308661.1_596,197,187,218,256,858
lcl|NC_002695.2_cds_NP_308662.1_597,155,161,185,246,747
lcl|NC_002695.2_cds_NP_308663.1_598,84,89,103,138,414
lcl|NC_002695.2_cds_NP_308664.1_599,366,544,518,678,2106
lcl|NC_002695.2_cds_YP_009502593.1_600,52,43,45,58,198
lcl|NC_002695.2_cds_NP_308665.1_601,231,253,295,310,1089
lcl|NC_002695.2_cds_NP_308666.1_602,257,275,306,323,1161
lcl|NC_002695.2_cds_NP_308667.1_603,189,145,148,148,630
lcl|NC_002695.2_cds_NP_308668.1_604,334,305,301,281,1221
lcl|NC_002695.2_cds_NP_308669.1_605,283,271,195,154,903
lcl|NC_002695.2_cds_NP_308670.3_606,233,162,172,180,747
lcl|NC_002695.2_cds_NP_308671.1_607,159,123,151,131,564
lcl|NC_002695.2_cds_NP_308672.1_608,420,338,394,444,1596
lcl|NC_002695.2_cds_NP_308673.1_609,103,115,107,104,429
lcl|NC_002695.2_cds_NP_308674.1_610,308,307,268,356,1239
lcl|NC_002695.2_cds_NP_308676.1_611,97,90,113,111,411
lcl|NC_002695.2_cds_NP_308677.1_612,205,185,212,205,807
lcl|NC_002695.2_cds_NP_308678.1_613,290,432,341,401,1464
lcl|NC_002695.2_cds_NP_308679.1_614,194,202,240,243,879
lcl|NC_002695.2_cds_NP_308680.1_615,115,116,172,149,552
lcl|NC_002695.2_cds_NP_308681.1_616,334,342,429,428,1533
lcl|NC_002695.2_cds_NP_308682.2_617,195,194,270,250,909
lcl|NC_002695.2_cds_NP_308683.1_618,72,60,84,81,297
lcl|NC_002695.2_cds_NP_308684.2_619,265,254,290,250,1059
lcl|NC_002695.2_cds_NP_308685.1_620,406,424,366,463,1659
lcl|NC_002695.2_cds_NP_308686.1_621,176,160,166,179,681
lcl|NC_002695.2_cds_NP_308687.1_622,270,410,338,368,1386
lcl|NC_002695.2_cds_NP_308688.1_623,142,158,120,141,561
lcl|NC_002695.2_cds_NP_308689.1_624,61,57,44,48,210
lcl|NC_002695.2_cds_NP_308690.1_625,81,113,84,106,384
lcl|NC_002695.2_cds_NP_308691.1_626,174,188,192,235,789
lcl|NC_002695.2_cds_NP_308692.1_627,54,48,36,66,204
lcl|NC_002695.2_cds_NP_308693.1_628,230,217,254,265,966
lcl|NC_002695.2_cds_NP_308694.2_629,267,261,233,193,954
lcl|NC_002695.2_cds_NP_308695.2_630,168,169,144,161,642
lcl|NC_002695.2_cds_NP_308696.1_631,80,62,64,58,264
lcl|NC_002695.2_cds_NP_308697.2_632,310,301,298,303,1212
lcl|NC_002695.2_cds_NP_308698.1_633,257,207,330,295,1089
lcl|NC_002695.2_cds_NP_308699.1_634,221,314,276,302,1113
lcl|NC_002695.2_cds_NP_308700.1_635,465,434,495,508,1902
lcl|NC_002695.2_cds_NP_308701.1_636,102,92,129,145,468
lcl|NC_002695.2_cds_NP_308702.2_637,79,78,72,89,318
lcl|NC_002695.2_cds_NP_308703.1_638,151,153,152,156,612
lcl|NC_002695.2_cds_NP_308704.1_639,169,155,168,150,642
lcl|NC_002695.2_cds_NP_308705.1_640,241,251,265,275,1032
lcl|NC_002695.2_cds_NP_308706.1_641,141,141,147,153,582
lcl|NC_002695.2_cds_NP_308707.1_642,660,551,649,723,2583
lcl|NC_002695.2_cds_NP_308708.1_643,132,97,110,144,483
lcl|NC_002695.2_cds_NP_308710.1_644,180,207,152,169,708
lcl|NC_002695.2_cds_NP_308711.1_645,372,382,326,348,1428
lcl|NC_002695.2_cds_NP_308712.1_646,178,140,120,117,555
lcl|NC_002695.2_cds_NP_308713.1_647,181,188,158,181,708
lcl|NC_002695.2_cds_NP_308716.1_648,427,406,389,449,1671
lcl|NC_002695.2_cds_NP_308717.1_649,228,232,230,246,936
lcl|NC_002695.2_cds_NP_308718.1_650,191,164,169,202,726
lcl|NC_002695.2_cds_NP_308719.1_651,123,209,158,185,675
lcl|NC_002695.2_cds_NP_308720.1_652,137,215,191,198,741
lcl|NC_002695.2_cds_NP_308721.1_653,269,197,226,217,909
lcl|NC_002695.2_cds_NP_308722.1_654,292,391,420,436,1539
lcl|NC_002695.2_cds_NP_308723.1_655,228,197,220,234,879
lcl|NC_002695.2_cds_NP_308724.1_656,124,101,105,138,468
lcl|NC_002695.2_cds_NP_308725.3_657,282,214,288,296,1080
lcl|NC_002695.2_cds_NP_308726.1_658,347,308,373,397,1425
lcl|NC_002695.2_cds_NP_308727.1_659,236,278,278,384,1176
lcl|NC_002695.2_cds_NP_308731.1_660,408,390,416,451,1665
lcl|NC_002695.2_cds_NP_308732.1_661,163,189,191,210,753
lcl|NC_002695.2_cds_NP_308733.1_662,296,276,330,319,1221
lcl|NC_002695.2_cds_NP_308734.1_663,286,264,292,307,1149
lcl|NC_002695.2_cds_NP_308735.1_664,214,197,199,191,801
lcl|NC_002695.2_cds_NP_308736.1_665,398,482,500,567,1947
lcl|NC_002695.2_cds_NP_308737.1_666,414,378,424,449,1665
lcl|NC_002695.2_cds_NP_308740.1_667,105,60,74,88,327
lcl|NC_002695.2_cds_NP_308741.1_668,129,101,112,105,447
lcl|NC_002695.2_cds_NP_308742.1_669,145,127,124,135,531
lcl|NC_002695.2_cds_NP_308743.1_670,103,66,92,102,363
lcl|NC_002695.2_cds_NP_308744.1_671,187,191,190,197,765
lcl|NC_002695.2_cds_NP_308745.1_672,152,125,134,135,546
lcl|NC_002695.2_cds_NP_308746.1_673,385,352,431,473,1641
lcl|NC_002695.2_cds_NP_308747.1_674,278,373,303,366,1320
lcl|NC_002695.2_cds_NP_308748.1_675,551,576,525,547,2199
lcl|NC_002695.2_cds_NP_308749.1_676,138,156,186,198,678
lcl|NC_002695.2_cds_NP_308750.1_677,559,574,726,826,2685
lcl|NC_002695.2_cds_NP_308751.1_678,137,127,152,157,573
lcl|NC_002695.2_cds_NP_308752.1_679,439,463,533,614,2049
lcl|NC_002695.2_cds_NP_308753.1_680,300,449,425,500,1674
lcl|NC_002695.2_cds_NP_308754.1_681,13,32,15,30,90
lcl|NC_002695.2_cds_NP_308755.1_682,45,57,52,53,207
lcl|NC_002695.2_cds_NP_308756.1_683,995,704,1228,1273,4200
lcl|NC_002695.2_cds_NP_308757.1_684,184,155,87,117,543
lcl|NC_002695.2_cds_NP_308758.1_685,346,274,190,264,1074
lcl|NC_002695.2_cds_NP_308759.1_686,114,141,141,114,510
lcl|NC_002695.2_cds_NP_308760.1_687,326,331,333,429,1419
lcl|NC_002695.2_cds_NP_308761.1_688,294,422,347,419,1482
lcl|NC_002695.2_cds_NP_308762.1_689,168,178,169,229,744
lcl|NC_002695.2_cds_NP_308763.1_690,123,156,158,220,657
lcl|NC_002695.2_cds_NP_308764.1_691,196,216,230,291,933
lcl|NC_002695.2_cds_NP_308765.1_692,176,142,192,225,735
lcl|NC_002695.2_cds_NP_308766.1_693,179,200,195,218,792
lcl|NC_002695.2_cds_NP_308767.2_694,172,283,290,302,1047
lcl|NC_002695.2_cds_NP_308768.1_695,297,267,262,236,1062
lcl|NC_002695.2_cds_NP_308769.1_696,196,151,205,180,732
lcl|NC_002695.2_cds_NP_308771.2_697,168,140,126,133,567
lcl|NC_002695.2_cds_NP_308772.1_698,313,326,335,310,1284
lcl|NC_002695.2_cds_NP_308773.2_699,86,121,102,96,405
lcl|NC_002695.2_cds_NP_308774.1_700,58,110,84,96,348
lcl|NC_002695.2_cds_NP_308775.1_701,390,389,459,529,1767
lcl|NC_002695.2_cds_NP_308776.1_702,167,179,177,194,717
lcl|NC_002695.2_cds_NP_308778.1_703,642,603,778,779,2802
lcl|NC_002695.2_cds_NP_308779.1_704,294,246,320,358,1218
lcl|NC_002695.2_cds_NP_308780.1_705,286,242,289,350,1167
lcl|NC_002695.2_cds_NP_308781.1_706,218,191,222,239,870
lcl|NC_002695.2_cds_NP_308782.1_707,239,264,187,216,906
lcl|NC_002695.2_cds_NP_308783.3_708,162,121,140,180,603
lcl|NC_002695.2_cds_NP_308784.1_709,458,383,403,409,1653
lcl|NC_002695.2_cds_NP_308785.3_710,288,366,322,305,1281
lcl|NC_002695.2_cds_NP_308786.1_711,99,98,60,61,318
lcl|NC_002695.2_cds_NP_308787.1_712,324,293,377,377,1371
lcl|NC_002695.2_cds_NP_308788.1_713,292,286,333,331,1242
lcl|NC_002695.2_cds_NP_308789.1_714,385,300,378,383,1446
lcl|NC_002695.2_cds_NP_308790.1_715,346,306,376,361,1389
lcl|NC_002695.2_cds_NP_308791.1_716,111,115,100,124,450
lcl|NC_002695.2_cds_NP_308793.1_717,142,127,92,62,423
lcl|NC_002695.2_cds_NP_308794.1_718,307,277,195,166,945
lcl|NC_002695.2_cds_NP_308795.2_719,315,424,403,427,1569
lcl|NC_002695.2_cds_NP_308796.1_720,213,313,293,321,1140
lcl|NC_002695.2_cds_YP_009502594.1_721,24,30,26,34,114
lcl|NC_002695.2_cds_NP_308797.1_722,48,99,64,83,294
lcl|NC_002695.2_cds_NP_308798.1_723,98,107,94,106,405
lcl|NC_002695.2_cds_NP_308799.1_724,166,179,165,183,693
lcl|NC_002695.2_cds_NP_308800.1_725,104,104,95,126,429
lcl|NC_002695.2_cds_NP_308801.1_726,394,170,261,360,1185
lcl|NC_002695.2_cds_NP_308802.1_727,282,321,331,359,1293
lcl|NC_002695.2_cds_NP_308803.1_728,141,113,132,136,522
lcl|NC_002695.2_cds_NP_308804.1_729,226,174,192,200,792
lcl|NC_002695.2_cds_NP_308805.1_730,269,244,247,284,1044
lcl|NC_002695.2_cds_NP_308806.1_731,153,223,154,190,720
lcl|NC_002695.2_cds_NP_308807.1_732,188,251,246,257,942
lcl|NC_002695.2_cds_NP_308808.1_733,119,65,101,96,381
lcl|NC_002695.2_cds_NP_308809.1_734,267,243,243,300,1053
lcl|NC_002695.2_cds_NP_308810.1_735,206,159,167,221,753
lcl|NC_002695.2_cds_NP_308811.1_736,232,235,286,288,1041
lcl|NC_002695.2_cds_NP_308812.1_737,285,259,292,313,1149
lcl|NC_002695.2_cds_NP_308813.1_738,252,218,296,281,1047
lcl|NC_002695.2_cds_NP_308814.3_739,251,213,285,268,1017
lcl|NC_002695.2_cds_NP_308815.1_740,333,367,376,397,1473
lcl|NC_002695.2_cds_NP_308816.1_741,208,167,208,206,789
lcl|NC_002695.2_cds_NP_308817.1_742,40,48,27,35,150
lcl|NC_002695.2_cds_NP_308818.1_743,199,184,175,216,774
lcl|NC_002695.2_cds_NP_308819.1_744,116,201,172,201,690
lcl|NC_002695.2_cds_NP_308820.1_745,252,242,254,311,1059
lcl|NC_002695.2_cds_NP_308821.1_746,207,188,213,211,819
lcl|NC_002695.2_cds_NP_308822.1_747,222,230,253,291,996
lcl|NC_002695.2_cds_NP_308823.3_748,272,261,193,228,954
lcl|NC_002695.2_cds_NP_308824.1_749,265,275,242,271,1053
lcl|NC_002695.2_cds_NP_308825.1_750,300,419,327,388,1434
lcl|NC_002695.2_cds_NP_308826.2_751,565,539,536,622,2262
lcl|NC_002695.2_cds_NP_308827.1_752,305,290,336,353,1284
lcl|NC_002695.2_cds_NP_308829.1_753,62,31,36,39,168
lcl|NC_002695.2_cds_NP_308831.2_754,166,203,99,135,603
lcl|NC_002695.2_cds_NP_308832.1_755,66,49,48,59,222
lcl|NC_002695.2_cds_NP_308833.2_756,67,44,54,51,216
lcl|NC_002695.2_cds_NP_308834.1_757,64,43,36,49,192
lcl|NC_002695.2_cds_NP_308835.1_758,49,44,45,45,183
lcl|NC_002695.2_cds_NP_308836.1_759,166,153,160,202,681
lcl|NC_002695.2_cds_NP_308839.1_760,213,104,146,161,624
lcl|NC_002695.2_cds_NP_308840.1_761,210,156,136,164,666
lcl|NC_002695.2_cds_NP_308841.1_762,314,268,183,195,960
lcl|NC_002695.2_cds_NP_308842.1_763,204,168,140,178,690
lcl|NC_002695.2_cds_NP_308843.3_764,181,293,101,169,744
lcl|NC_002695.2_cds_NP_303550.1_765,117,101,104,77,399
lcl|NC_002695.2_cds_NP_308845.1_766,62,52,40,62,216
lcl|NC_002695.2_cds_NP_308846.1_767,131,111,119,137,498
lcl|NC_002695.2_cds_NP_308847.1_768,127,99,123,119,468
lcl|NC_002695.2_cds_NP_308848.1_769,53,43,57,54,207
lcl|NC_002695.2_cds_NP_308849.1_770,33,48,32,40,153
lcl|NC_002695.2_cds_NP_308851.1_771,125,113,109,145,492
lcl|NC_002695.2_cds_NP_308852.1_772,487,469,524,623,2103
lcl|NC_002695.2_cds_NP_308853.2_773,255,251,268,351,1125
lcl|NC_002695.2_cds_NP_308856.2_774,506,478,470,574,2028
lcl|NC_002695.2_cds_NP_308857.2_775,89,69,60,106,324
lcl|NC_002695.2_cds_NP_308858.1_776,63,69,64,80,276
lcl|NC_002695.2_cds_NP_308859.1_777,139,116,143,181,579
lcl|NC_002695.2_cds_NP_308860.1_778,96,92,102,112,402
lcl|NC_002695.2_cds_NP_308861.1_779,180,149,183,232,744
lcl|NC_002695.2_cds_NP_308862.1_780,87,95,74,131,387
lcl|NC_002695.2_cds_NP_308863.1_781,66,80,65,119,330
lcl|NC_002695.2_cds_NP_308864.1_782,807,620,692,947,3066
lcl|NC_002695.2_cds_NP_308865.1_783,80,77,66,107,330
lcl|NC_002695.2_cds_NP_308866.1_784,162,145,178,214,699
lcl|NC_002695.2_cds_NP_308867.2_785,139,165,194,246,744
lcl|NC_002695.2_cds_NP_308868.2_786,102,114,118,179,513
lcl|NC_002695.2_cds_NP_308869.1_787,821,671,849,1073,3414
lcl|NC_002695.2_cds_NP_308870.1_788,129,146,141,184,600
lcl|NC_002695.2_cds_NP_308871.1_789,359,191,313,454,1317
lcl|NC_002695.2_cds_NP_308872.2_790,82,58,45,85,270
lcl|NC_002695.2_cds_NP_308873.1_791,335,314,135,197,981
lcl|NC_002695.2_cds_NP_308874.2_792,302,271,216,231,1020
lcl|NC_002695.2_cds_NP_308875.1_793,271,259,140,212,882
lcl|NC_002695.2_cds_NP_308876.1_794,30,41,23,41,135
lcl|NC_002695.2_cds_NP_308877.1_795,201,190,147,161,699
lcl|NC_002695.2_cds_NP_308878.1_796,103,122,116,136,477
lcl|NC_002695.2_cds_NP_308879.1_797,279,289,350,372,1290
lcl|NC_002695.2_cds_NP_308880.1_798,268,209,265,299,1041
lcl|NC_002695.2_cds_NP_308881.1_799,229,257,307,362,1155
lcl|NC_002695.2_cds_NP_308882.1_800,163,164,204,225,756
lcl|NC_002695.2_cds_NP_308883.1_801,168,139,175,196,678
lcl|NC_002695.2_cds_NP_308884.1_802,495,455,500,572,2022
lcl|NC_002695.2_cds_NP_308885.1_803,207,231,209,262,909
lcl|NC_002695.2_cds_NP_308886.1_804,224,230,273,263,990
lcl|NC_002695.2_cds_NP_308887.1_805,117,129,122,145,513
lcl|NC_002695.2_cds_NP_308888.1_806,116,97,121,152,486
lcl|NC_002695.2_cds_NP_308889.1_807,52,56,63,75,246
lcl|NC_002695.2_cds_NP_308890.1_808,109,85,113,146,453
lcl|NC_002695.2_cds_NP_308891.1_809,146,219,160,180,705
lcl|NC_002695.2_cds_NP_308892.1_810,176,236,131,171,714
lcl|NC_002695.2_cds_NP_308893.1_811,179,268,231,279,957
lcl|NC_002695.2_cds_NP_308894.1_812,296,270,323,353,1242
lcl|NC_002695.2_cds_NP_308895.1_813,167,173,211,211,762
lcl|NC_002695.2_cds_NP_308896.1_814,79,108,91,133,411
lcl|NC_002695.2_cds_NP_308897.1_815,248,279,302,278,1107
lcl|NC_002695.2_cds_NP_308898.1_816,214,294,302,324,1134
lcl|NC_002695.2_cds_NP_308899.2_817,410,360,455,512,1737
lcl|NC_002695.2_cds_NP_308900.2_818,228,197,258,313,996
lcl|NC_002695.2_cds_NP_308901.2_819,164,143,197,168,672
lcl|NC_002695.2_cds_NP_308902.1_820,318,280,375,395,1368
lcl|NC_002695.2_cds_NP_308903.1_821,681,632,330,370,2013
lcl|NC_002695.2_cds_NP_308904.1_822,509,485,538,619,2151
lcl|NC_002695.2_cds_NP_308905.1_823,225,201,249,288,963
lcl|NC_002695.2_cds_NP_308906.1_824,233,247,276,330,1086
lcl|NC_002695.2_cds_NP_308907.1_825,69,61,65,66,261
lcl|NC_002695.2_cds_NP_308908.1_826,76,56,62,73,267
lcl|NC_002695.2_cds_NP_308909.3_827,173,155,184,172,684
lcl|NC_002695.2_cds_NP_308910.1_828,568,489,647,579,2283
lcl|NC_002695.2_cds_NP_308911.2_829,74,49,71,67,261
lcl|NC_002695.2_cds_NP_308912.2_830,218,206,238,265,927
lcl|NC_002695.2_cds_NP_308913.1_831,466,571,586,603,2226
lcl|NC_002695.2_cds_NP_308914.1_832,176,162,180,205,723
lcl|NC_002695.2_cds_NP_308915.1_833,123,184,166,187,660
lcl|NC_002695.2_cds_NP_308916.1_834,216,164,174,193,747
lcl|NC_002695.2_cds_NP_308917.1_835,146,113,128,117,504
lcl|NC_002695.2_cds_NP_308918.1_836,158,254,220,256,888
lcl|NC_002695.2_cds_NP_308919.1_837,131,120,136,129,516
lcl|NC_002695.2_cds_NP_308920.1_838,405,408,386,385,1584
lcl|NC_002695.2_cds_NP_308921.1_839,118,101,96,153,468
lcl|NC_002695.2_cds_NP_308922.1_840,196,339,250,334,1119
lcl|NC_002695.2_cds_NP_308923.1_841,224,206,244,247,921
lcl|NC_002695.2_cds_NP_308924.1_842,398,356,381,458,1593
lcl|NC_002695.2_cds_NP_308925.1_843,293,269,346,358,1266
lcl|NC_002695.2_cds_NP_308926.1_844,232,206,187,191,816
lcl|NC_002695.2_cds_NP_308929.1_845,209,199,254,238,900
lcl|NC_002695.2_cds_NP_308930.3_846,148,159,144,212,663
lcl|NC_002695.2_cds_NP_308931.1_847,162,169,190,229,750
lcl|NC_002695.2_cds_NP_308932.1_848,257,278,334,367,1236
lcl|NC_002695.2_cds_NP_308935.2_849,401,459,466,546,1872
lcl|NC_002695.2_cds_NP_308936.1_850,408,327,370,434,1539
lcl|NC_002695.2_cds_NP_308937.1_851,167,257,217,280,921
lcl|NC_002695.2_cds_NP_308938.1_852,159,273,219,261,912
lcl|NC_002695.2_cds_NP_308939.1_853,687,684,440,538,2349
lcl|NC_002695.2_cds_NP_308940.1_854,359,392,254,324,1329
lcl|NC_002695.2_cds_YP_009502595.1_855,110,68,66,86,330
lcl|NC_002695.2_cds_YP_009502596.1_856,133,95,60,99,387
lcl|NC_002695.2_cds_NP_308942.1_857,336,292,333,365,1326
lcl|NC_002695.2_cds_NP_308943.1_858,107,90,88,99,384
lcl|NC_002695.2_cds_NP_308944.1_859,269,270,269,308,1116
lcl|NC_002695.2_cds_NP_308945.2_860,160,143,152,172,627
lcl|NC_002695.2_cds_NP_308946.1_861,290,288,274,351,1203
lcl|NC_002695.2_cds_NP_308947.1_862,186,191,182,200,759
lcl|NC_002695.2_cds_NP_308948.1_863,107,179,147,164,597
lcl|NC_002695.2_cds_NP_308949.1_864,236,353,277,367,1233
lcl|NC_002695.2_cds_NP_308950.2_865,58,72,72,77,279
lcl|NC_002695.2_cds_NP_308951.2_866,237,206,165,208,816
lcl|NC_002695.2_cds_NP_308952.1_867,203,337,303,366,1209
lcl|NC_002695.2_cds_NP_308953.1_868,135,126,125,151,537
lcl|NC_002695.2_cds_NP_308954.1_869,358,460,401,467,1686
lcl|NC_002695.2_cds_NP_308955.1_870,74,119,87,98,378
lcl|NC_002695.2_cds_NP_308956.1_871,74,66,50,68,258
lcl|NC_002695.2_cds_NP_308957.1_872,63,80,68,77,288
lcl|NC_002695.2_cds_NP_308958.1_873,172,172,184,195,723
lcl|NC_002695.2_cds_NP_308959.1_874,193,203,220,287,903
lcl|NC_002695.2_cds_NP_308960.1_875,109,136,112,120,477
lcl|NC_002695.2_cds_NP_308961.1_876,289,257,273,294,1113
lcl|NC_002695.2_cds_NP_308962.1_877,257,260,284,333,1134
lcl|NC_002695.2_cds_NP_308963.1_878,191,276,224,263,954
lcl|NC_002695.2_cds_NP_308964.1_879,142,240,205,259,846
lcl|NC_002695.2_cds_NP_308965.1_880,93,142,116,138,489
lcl|NC_002695.2_cds_NP_308966.1_881,252,257,302,317,1128
lcl|NC_002695.2_cds_NP_308967.2_882,295,440,268,323,1326
lcl|NC_002695.2_cds_NP_308968.1_883,102,97,50,72,321
lcl|NC_002695.2_cds_NP_308969.1_884,349,357,343,433,1482
lcl|NC_002695.2_cds_NP_308970.1_885,220,169,175,168,732
lcl|NC_002695.2_cds_NP_308971.1_886,132,183,159,195,669
lcl|NC_002695.2_cds_NP_308972.1_887,127,198,180,212,717
lcl|NC_002695.2_cds_NP_308973.1_888,212,160,176,184,732
lcl|NC_002695.2_cds_NP_308974.1_889,181,165,194,189,729
lcl|NC_002695.2_cds_NP_308975.1_890,117,121,149,129,516
lcl|NC_002695.2_cds_NP_308976.1_891,434,401,178,229,1242
lcl|NC_002695.2_cds_NP_308977.2_892,91,91,51,58,291
lcl|NC_002695.2_cds_NP_308979.1_893,71,76,73,104,324
lcl|NC_002695.2_cds_NP_308980.1_894,190,169,217,255,831
lcl|NC_002695.2_cds_NP_308981.2_895,235,227,283,269,1014
lcl|NC_002695.2_cds_NP_308982.1_896,321,333,379,398,1431
lcl|NC_002695.2_cds_NP_308983.1_897,231,210,274,287,1002
lcl|NC_002695.2_cds_NP_308984.1_898,412,372,446,489,1719
lcl|NC_002695.2_cds_NP_308985.1_899,213,219,256,281,969
lcl|NC_002695.2_cds_NP_308986.2_900,374,378,451,450,1653
lcl|NC_002695.2_cds_NP_308987.1_901,164,297,217,222,900
lcl|NC_002695.2_cds_NP_308988.1_902,118,216,155,207,696
lcl|NC_002695.2_cds_NP_308989.1_903,356,426,411,466,1659
lcl|NC_002695.2_cds_NP_308990.1_904,255,244,241,253,993
lcl|NC_002695.2_cds_NP_308991.2_905,296,224,267,329,1116
lcl|NC_002695.2_cds_NP_308992.1_906,417,482,467,581,1947
lcl|NC_002695.2_cds_NP_308993.1_907,61,55,48,61,225
lcl|NC_002695.2_cds_NP_308994.1_908,96,80,61,84,321
lcl|NC_002695.2_cds_NP_308995.1_909,564,515,548,650,2277
lcl|NC_002695.2_cds_NP_308996.1_910,65,48,55,51,219
lcl|NC_002695.2_cds_NP_308997.1_911,144,182,193,186,705
lcl|NC_002695.2_cds_NP_308998.1_912,358,437,454,473,1722
lcl|NC_002695.2_cds_NP_308999.1_913,361,463,454,489,1767
lcl|NC_002695.2_cds_NP_309000.1_914,238,214,259,255,966
lcl|NC_002695.2_cds_NP_309001.1_915,127,132,108,128,495
lcl|NC_002695.2_cds_NP_309002.1_916,960,892,1076,1101,4029
lcl|NC_002695.2_cds_NP_309003.2_917,174,126,152,160,612
lcl|NC_002695.2_cds_NP_309004.1_918,317,311,341,375,1344
lcl|NC_002695.2_cds_NP_309005.1_919,322,290,320,361,1293
lcl|NC_002695.2_cds_NP_309006.2_920,626,531,614,674,2445
lcl|NC_002695.2_cds_NP_309007.1_921,149,150,148,171,618
lcl|NC_002695.2_cds_NP_309008.1_922,140,246,205,273,864
lcl|NC_002695.2_cds_NP_309009.1_923,164,174,138,151,627
lcl|NC_002695.2_cds_NP_309010.1_924,207,340,273,329,1149
lcl|NC_002695.2_cds_NP_309011.2_925,318,430,305,378,1431
lcl|NC_002695.2_cds_NP_309012.1_926,192,182,173,194,741
lcl|NC_002695.2_cds_NP_309013.1_927,587,523,611,562,2283
lcl|NC_002695.2_cds_NP_309014.1_928,186,255,202,215,858
lcl|NC_002695.2_cds_NP_309015.2_929,422,444,428,467,1761
lcl|NC_002695.2_cds_NP_309016.1_930,166,198,133,196,693
lcl|NC_002695.2_cds_NP_309017.1_931,264,277,256,292,1089
lcl|NC_002695.2_cds_NP_309018.1_932,313,325,301,345,1284
lcl|NC_002695.2_cds_NP_309019.2_933,206,175,185,199,765
lcl|NC_002695.2_cds_NP_309020.1_934,158,159,170,197,684
lcl|NC_002695.2_cds_NP_309021.1_935,448,369,398,459,1674
lcl|NC_002695.2_cds_NP_309022.1_936,84,61,70,70,285
lcl|NC_002695.2_cds_NP_309023.2_937,507,633,522,603,2265
lcl|NC_002695.2_cds_NP_309024.1_938,401,459,423,466,1749
lcl|NC_002695.2_cds_NP_309025.1_939,198,244,238,307,987
lcl|NC_002695.2_cds_NP_309026.1_940,292,296,306,339,1233
lcl|NC_002695.2_cds_NP_309027.1_941,50,45,42,46,183
lcl|NC_002695.2_cds_NP_309028.1_942,164,182,188,213,747
lcl|NC_002695.2_cds_NP_309029.1_943,217,210,213,254,894
lcl|NC_002695.2_cds_NP_309030.1_944,187,188,190,215,780
lcl|NC_002695.2_cds_NP_309031.1_945,193,187,175,231,786
lcl|NC_002695.2_cds_NP_309032.1_946,322,306,321,374,1323
lcl|NC_002695.2_cds_NP_309033.1_947,173,169,174,189,705
lcl|NC_002695.2_cds_NP_309034.1_948,1052,919,1165,1325,4461
lcl|NC_002695.2_cds_NP_309035.1_949,449,418,477,504,1848
lcl|NC_002695.2_cds_NP_309036.1_950,144,131,145,129,549
lcl|NC_002695.2_cds_NP_309037.1_951,151,160,158,179,648
lcl|NC_002695.2_cds_NP_309038.1_952,293,274,310,314,1191
lcl|NC_002695.2_cds_NP_309039.1_953,288,282,249,270,1089
lcl|NC_002695.2_cds_NP_309040.1_954,318,345,354,384,1401
lcl|NC_002695.2_cds_NP_309041.1_955,274,314,308,307,1203
lcl|NC_002695.2_cds_NP_309042.1_956,622,590,695,706,2613
lcl|NC_002695.2_cds_NP_309043.1_957,167,176,166,259,768
lcl|NC_002695.2_cds_NP_309044.1_958,131,224,189,248,792
lcl|NC_002695.2_cds_NP_309045.1_959,240,247,316,343,1146
lcl|NC_002695.2_cds_NP_309046.1_960,239,217,258,246,960
lcl|NC_002695.2_cds_NP_309047.1_961,122,144,163,147,576
lcl|NC_002695.2_cds_NP_309048.2_962,162,150,103,125,540
lcl|NC_002695.2_cds_NP_309049.1_963,211,170,162,159,702
lcl|NC_002695.2_cds_NP_309052.1_964,242,258,224,257,981
lcl|NC_002695.2_cds_NP_309053.2_965,123,121,109,124,477
lcl|NC_002695.2_cds_NP_309054.3_966,143,153,113,155,564
lcl|NC_002695.2_cds_NP_309056.1_967,276,266,227,242,1011
lcl|NC_002695.2_cds_NP_309057.2_968,134,142,126,141,543
lcl|NC_002695.2_cds_NP_309058.1_969,271,282,275,282,1110
lcl|NC_002695.2_cds_NP_309059.1_970,498,467,538,606,2109
lcl|NC_002695.2_cds_NP_309060.1_971,497,398,461,552,1908
lcl|NC_002695.2_cds_NP_309061.1_972,237,363,299,355,1254
lcl|NC_002695.2_cds_NP_309062.1_973,435,380,368,458,1641
lcl|NC_002695.2_cds_NP_309063.2_974,142,125,131,166,564
lcl|NC_002695.2_cds_NP_309064.1_975,51,26,38,53,168
lcl|NC_002695.2_cds_NP_309065.2_976,146,157,142,182,627
lcl|NC_002695.2_cds_NP_309066.1_977,416,430,446,469,1761
lcl|NC_002695.2_cds_NP_309067.1_978,143,100,90,120,453
lcl|NC_002695.2_cds_NP_309068.1_979,252,231,285,273,1041
lcl|NC_002695.2_cds_NP_309069.1_980,131,133,123,123,510
lcl|NC_002695.2_cds_NP_309070.1_981,166,162,130,172,630
lcl|NC_002695.2_cds_NP_309071.3_982,452,582,567,562,2163
lcl|NC_002695.2_cds_NP_309072.1_983,93,137,100,117,447
lcl|NC_002695.2_cds_NP_309073.1_984,506,464,479,606,2055
lcl|NC_002695.2_cds_NP_309074.2_985,113,104,120,122,459
lcl|NC_002695.2_cds_NP_309075.1_986,160,168,172,163,663
lcl|NC_002695.2_cds_NP_309076.1_987,99,85,103,127,414
lcl|NC_002695.2_cds_NP_309077.2_988,70,70,90,88,318
lcl|NC_002695.2_cds_NP_309078.3_989,269,293,285,329,1176
lcl|NC_002695.2_cds_NP_309079.1_990,71,61,59,88,279
lcl|NC_002695.2_cds_NP_309080.2_991,99,77,64,90,330
lcl|NC_002695.2_cds_NP_309081.1_992,123,205,164,168,660
lcl|NC_002695.2_cds_NP_309082.1_993,351,215,202,252,1020
lcl|NC_002695.2_cds_NP_303789.1_994,89,48,59,47,243
lcl|NC_002695.2_cds_NP_309084.1_995,751,505,587,629,2472
lcl|NC_002695.2_cds_NP_309085.1_996,62,52,40,38,192
lcl|NC_002695.2_cds_NP_309086.1_997,64,48,36,41,189
lcl|NC_002695.2_cds_NP_309088.1_998,61,55,39,31,186
lcl|NC_002695.2_cds_NP_309090.1_999,138,101,70,81,390
lcl|NC_002695.2_cds_NP_303797.1_1000,41,29,28,31,129
lcl|NC_002695.2_cds_NP_309092.1_1001,48,33,36,39,156
lcl|NC_002695.2_cds_NP_309094.1_1002,80,76,76,56,288
lcl|NC_002695.2_cds_NP_309095.1_1003,66,43,44,39,192
lcl|NC_002695.2_cds_NP_309096.2_1004,125,91,86,100,402
lcl|NC_002695.2_cds_NP_309097.1_1005,83,68,59,63,273
lcl|NC_002695.2_cds_NP_309098.1_1006,116,92,98,120,426
lcl|NC_002695.2_cds_YP_009502597.1_1007,123,126,116,91,456
lcl|NC_002695.2_cds_NP_309100.1_1008,281,228,239,344,1092
lcl|NC_002695.2_cds_NP_309101.1_1009,203,156,161,227,747
lcl|NC_002695.2_cds_NP_309102.1_1010,203,159,174,235,771
lcl|NC_002695.2_cds_NP_309103.1_1011,127,92,76,119,414
lcl|NC_002695.2_cds_NP_309104.1_1012,257,251,147,119,774
lcl|NC_002695.2_cds_NP_303812.1_1013,35,37,39,27,138
lcl|NC_002695.2_cds_NP_309107.1_1014,61,41,50,61,213
lcl|NC_002695.2_cds_NP_309109.2_1015,257,236,274,283,1050
lcl|NC_002695.2_cds_NP_309110.1_1016,88,85,86,113,372
lcl|NC_002695.2_cds_NP_309111.1_1017,104,113,52,103,372
lcl|NC_002695.2_cds_NP_309112.1_1018,169,341,127,182,819
lcl|NC_002695.2_cds_NP_309113.1_1019,55,62,50,73,240
lcl|NC_002695.2_cds_NP_309114.1_1020,164,177,110,137,588
lcl|NC_002695.2_cds_NP_309115.1_1021,440,384,477,550,1851
lcl|NC_002695.2_cds_NP_309116.1_1022,75,75,79,98,327
lcl|NC_002695.2_cds_NP_309117.2_1023,174,131,152,194,651
lcl|NC_002695.2_cds_NP_309118.1_1024,108,52,59,96,315
lcl|NC_002695.2_cds_NP_309120.2_1025,120,121,131,153,525
lcl|NC_002695.2_cds_NP_309119.2_1026,41,34,57,54,186
lcl|NC_002695.2_cds_NP_309121.1_1027,24,32,22,36,114
lcl|NC_002695.2_cds_NP_309123.1_1028,130,114,125,165,534
lcl|NC_002695.2_cds_NP_309125.2_1029,95,70,60,48,273
lcl|NC_002695.2_cds_NP_309127.1_1030,52,46,43,66,207
lcl|NC_002695.2_cds_NP_309128.1_1031,81,59,57,79,276
lcl|NC_002695.2_cds_NP_309129.1_1032,102,81,107,91,381
lcl|NC_002695.2_cds_NP_309130.1_1033,69,75,99,105,348
lcl|NC_002695.2_cds_NP_309131.1_1034,345,294,425,475,1539
lcl|NC_002695.2_cds_NP_303838.1_1035,68,66,55,54,243
lcl|NC_002695.2_cds_NP_309133.2_1036,482,443,458,582,1965
lcl|NC_002695.2_cds_YP_009502598.1_1037,43,48,46,70,207
lcl|NC_002695.2_cds_NP_309134.1_1038,347,342,380,524,1593
lcl|NC_002695.2_cds_NP_309135.1_1039,308,287,405,506,1506
lcl|NC_002695.2_cds_NP_309136.1_1040,89,64,88,107,348
lcl|NC_002695.2_cds_NP_309137.1_1041,63,64,65,75,267
lcl|NC_002695.2_cds_NP_309138.2_1042,167,118,139,206,630
lcl|NC_002695.2_cds_NP_309139.2_1043,105,97,103,127,432
lcl|NC_002695.2_cds_NP_309140.2_1044,80,101,96,137,414
lcl|NC_002695.2_cds_NP_309141.1_1045,583,478,633,886,2580
lcl|NC_002695.2_cds_NP_309142.1_1046,68,72,76,114,330
lcl|NC_002695.2_cds_NP_309143.1_1047,146,150,156,247,699
lcl|NC_002695.2_cds_NP_309144.2_1048,150,167,190,237,744
lcl|NC_002695.2_cds_NP_309145.2_1049,117,115,153,197,582
lcl|NC_002695.2_cds_NP_309147.1_1050,140,108,145,135,528
lcl|NC_002695.2_cds_NP_309148.1_1051,797,674,920,1083,3474
lcl|NC_002695.2_cds_NP_309149.1_1052,125,143,147,185,600
lcl|NC_002695.2_cds_NP_309150.2_1053,334,191,324,465,1314
lcl|NC_002695.2_cds_NP_309151.1_1054,82,56,46,86,270
lcl|NC_002695.2_cds_NP_309155.1_1055,254,249,311,305,1119
lcl|NC_002695.2_cds_NP_309156.1_1056,403,376,507,508,1794
lcl|NC_002695.2_cds_NP_309157.1_1057,148,193,167,200,708
lcl|NC_002695.2_cds_NP_309158.1_1058,127,117,151,193,588
lcl|NC_002695.2_cds_NP_309159.1_1059,88,88,102,121,399
lcl|NC_002695.2_cds_NP_309160.1_1060,201,187,220,250,858
lcl|NC_002695.2_cds_NP_309161.1_1061,310,399,398,438,1545
lcl|NC_002695.2_cds_NP_309162.1_1062,188,344,266,339,1137
lcl|NC_002695.2_cds_NP_309163.1_1063,316,286,345,358,1305
lcl|NC_002695.2_cds_NP_309164.1_1064,566,509,521,585,2181
lcl|NC_002695.2_cds_NP_309165.2_1065,113,100,107,127,447
lcl|NC_002695.2_cds_NP_309166.1_1066,296,264,278,302,1140
lcl|NC_002695.2_cds_NP_309167.1_1067,501,504,536,556,2097
lcl|NC_002695.2_cds_NP_309168.1_1068,173,185,197,192,747
lcl|NC_002695.2_cds_NP_309169.1_1069,168,166,153,158,645
lcl|NC_002695.2_cds_NP_309170.2_1070,67,60,90,89,306
lcl|NC_002695.2_cds_NP_309172.1_1071,63,57,45,48,213
lcl|NC_002695.2_cds_NP_309174.1_1072,241,309,243,281,1074
lcl|NC_002695.2_cds_NP_309175.3_1073,667,564,715,754,2700
lcl|NC_002695.2_cds_NP_309176.1_1074,234,246,245,304,1029
lcl|NC_002695.2_cds_NP_309177.1_1075,157,168,170,198,693
lcl|NC_002695.2_cds_NP_309178.1_1076,321,250,290,312,1173
lcl|NC_002695.2_cds_NP_309179.1_1077,579,562,641,765,2547
lcl|NC_002695.2_cds_NP_309180.1_1078,146,139,144,171,600
lcl|NC_002695.2_cds_NP_309181.1_1079,63,76,73,94,306
lcl|NC_002695.2_cds_NP_309182.1_1080,244,187,235,255,921
lcl|NC_002695.2_cds_NP_309185.1_1081,331,266,306,339,1242
lcl|NC_002695.2_cds_NP_309186.1_1082,73,46,47,62,228
lcl|NC_002695.2_cds_NP_309187.1_1083,401,294,302,314,1311
lcl|NC_002695.2_cds_NP_309188.1_1084,100,58,68,59,285
lcl|NC_002695.2_cds_NP_309189.2_1085,98,71,62,69,300
lcl|NC_002695.2_cds_NP_309190.2_1086,91,66,57,71,285
lcl|NC_002695.2_cds_NP_309191.1_1087,183,144,139,158,624
lcl|NC_002695.2_cds_NP_309192.1_1088,83,62,59,84,288
lcl|NC_002695.2_cds_NP_309193.1_1089,70,65,39,45,219
lcl|NC_002695.2_cds_NP_309194.2_1090,63,49,42,62,216
lcl|NC_002695.2_cds_NP_309195.2_1091,59,39,35,56,189
lcl|NC_002695.2_cds_NP_309196.1_1092,247,159,162,206,774
lcl|NC_002695.2_cds_NP_309197.1_1093,64,49,49,60,222
lcl|NC_002695.2_cds_NP_309198.1_1094,67,44,53,52,216
lcl|NC_002695.2_cds_NP_309199.1_1095,66,36,43,47,192
lcl|NC_002695.2_cds_NP_309200.1_1096,50,45,43,45,183
lcl|NC_002695.2_cds_NP_309201.1_1097,170,155,160,196,681
lcl|NC_002695.2_cds_NP_309202.1_1098,208,166,205,207,786
lcl|NC_002695.2_cds_NP_309203.2_1099,84,64,72,77,297
lcl|NC_002695.2_cds_NP_309204.2_1100,52,39,27,26,144
lcl|NC_002695.2_cds_NP_309205.1_1101,49,41,41,34,165
lcl|NC_002695.2_cds_NP_309206.1_1102,130,98,64,77,369
lcl|NC_002695.2_cds_NP_309207.1_1103,77,68,52,55,252
lcl|NC_002695.2_cds_NP_309208.1_1104,96,48,72,57,273
lcl|NC_002695.2_cds_YP_009502599.1_1105,59,37,43,44,183
lcl|NC_002695.2_cds_NP_309211.1_1106,172,118,116,116,522
lcl|NC_002695.2_cds_NP_309212.2_1107,182,172,138,162,654
lcl|NC_002695.2_cds_NP_309213.1_1108,63,50,52,51,216
lcl|NC_002695.2_cds_NP_309214.1_1109,93,73,63,68,297
lcl|NC_002695.2_cds_NP_309215.1_1110,50,30,33,34,147
lcl|NC_002695.2_cds_NP_309216.1_1111,294,197,201,208,900
lcl|NC_002695.2_cds_NP_309217.2_1112,404,308,343,382,1437
lcl|NC_002695.2_cds_NP_309218.1_1113,98,61,48,63,270
lcl|NC_002695.2_cds_NP_309219.1_1114,91,61,45,82,279
lcl|NC_002695.2_cds_NP_309220.1_1115,48,65,45,58,216
lcl|NC_002695.2_cds_NP_309221.1_1116,68,50,48,71,237
lcl|NC_002695.2_cds_NP_309222.1_1117,123,87,112,125,447
lcl|NC_002695.2_cds_NP_309223.1_1118,139,115,119,155,528
lcl|NC_002695.2_cds_NP_309226.1_1119,212,181,174,168,735
lcl|NC_002695.2_cds_NP_309227.1_1120,208,165,158,192,723
lcl|NC_002695.2_cds_NP_309228.1_1121,208,96,148,154,606
lcl|NC_002695.2_cds_NP_309229.1_1122,66,40,39,50,195
lcl|NC_002695.2_cds_NP_309230.1_1123,106,109,81,139,435
lcl|NC_002695.2_cds_NP_309232.1_1124,259,269,200,232,960
lcl|NC_002695.2_cds_NP_309233.1_1125,81,77,43,69,270
lcl|NC_002695.2_cds_NP_309234.1_1126,448,414,464,579,1905
lcl|NC_002695.2_cds_NP_309235.2_1127,219,189,209,271,888
lcl|NC_002695.2_cds_NP_309236.1_1128,75,75,79,98,327
lcl|NC_002695.2_cds_YP_009502600.1_1129,68,56,67,79,270
lcl|NC_002695.2_cds_NP_309237.1_1130,43,43,43,51,180
lcl|NC_002695.2_cds_NP_309238.2_1131,74,51,70,78,273
lcl|NC_002695.2_cds_NP_309239.1_1132,53,47,46,70,216
lcl|NC_002695.2_cds_NP_309240.1_1133,128,117,126,163,534
lcl|NC_002695.2_cds_NP_309241.1_1134,169,137,115,149,570
lcl|NC_002695.2_cds_YP_009502601.1_1135,28,48,30,41,147
lcl|NC_002695.2_cds_NP_309242.1_1136,120,92,119,134,465
lcl|NC_002695.2_cds_NP_309243.1_1137,41,34,56,55,186
lcl|NC_002695.2_cds_NP_309244.1_1138,94,75,64,61,294
lcl|NC_002695.2_cds_NP_309245.3_1139,52,47,46,59,204
lcl|NC_002695.2_cds_NP_309246.1_1140,250,164,193,200,807
lcl|NC_002695.2_cds_NP_309247.1_1141,468,392,397,450,1707
lcl|NC_002695.2_cds_NP_309248.1_1142,542,481,490,632,2145
lcl|NC_002695.2_cds_NP_309249.1_1143,279,193,233,303,1008
lcl|NC_002695.2_cds_NP_309250.1_1144,314,273,293,335,1215
lcl|NC_002695.2_cds_NP_309251.1_1145,89,95,98,108,390
lcl|NC_002695.2_cds_NP_309252.1_1146,116,98,100,148,462
lcl|NC_002695.2_cds_NP_309253.1_1147,114,153,136,161,564
lcl|NC_002695.2_cds_NP_309254.1_1148,152,165,136,198,651
lcl|NC_002695.2_cds_NP_309255.1_1149,490,273,449,726,1938
lcl|NC_002695.2_cds_NP_309256.1_1150,81,57,46,86,270
lcl|NC_002695.2_cds_NP_309257.2_1151,58,51,30,50,189
lcl|NC_002695.2_cds_NP_309259.2_1152,366,412,374,474,1626
lcl|NC_002695.2_cds_NP_309260.1_1153,332,306,253,378,1269
lcl|NC_002695.2_cds_NP_309261.1_1154,81,84,47,67,279
lcl|NC_002695.2_cds_NP_309262.1_1155,181,176,118,143,618
lcl|NC_002695.2_cds_NP_309263.1_1156,199,195,144,197,735
lcl|NC_002695.2_cds_NP_309264.1_1157,87,110,77,128,402
lcl|NC_002695.2_cds_NP_309265.1_1158,180,128,142,207,657
lcl|NC_002695.2_cds_NP_309266.1_1159,117,78,113,139,447
lcl|NC_002695.2_cds_NP_309267.1_1160,64,58,45,85,252
lcl|NC_002695.2_cds_NP_309268.1_1161,368,269,286,343,1266
lcl|NC_002695.2_cds_NP_309269.1_1162,2129,1702,1975,2576,8382
lcl|NC_002695.2_cds_NP_309271.1_1163,108,86,50,101,345
lcl|NC_002695.2_cds_NP_309272.1_1164,61,44,47,61,213
lcl|NC_002695.2_cds_NP_309273.1_1165,128,83,77,108,396
lcl|NC_002695.2_cds_NP_309274.1_1166,185,133,144,198,660
lcl|NC_002695.2_cds_NP_309275.1_1167,72,50,40,57,219
lcl|NC_002695.2_cds_NP_309276.1_1168,87,61,63,74,285
lcl|NC_002695.2_cds_NP_309277.1_1169,63,49,52,58,222
lcl|NC_002695.2_cds_NP_309278.1_1170,204,129,152,145,630
lcl|NC_002695.2_cds_NP_309279.2_1171,245,371,298,415,1329
lcl|NC_002695.2_cds_NP_309280.2_1172,94,109,149,143,495
lcl|NC_002695.2_cds_NP_309281.1_1173,127,133,171,160,591
lcl|NC_002695.2_cds_NP_309282.1_1174,161,177,230,233,801
lcl|NC_002695.2_cds_NP_309283.1_1175,93,86,108,100,387
lcl|NC_002695.2_cds_NP_309284.4_1176,154,160,193,189,696
lcl|NC_002695.2_cds_NP_309285.4_1177,242,244,306,300,1092
lcl|NC_002695.2_cds_NP_309286.1_1178,156,157,146,180,639
lcl|NC_002695.2_cds_NP_309287.1_1179,869,852,1073,1169,3963
lcl|NC_002695.2_cds_NP_309288.1_1180,281,412,340,476,1509
lcl|NC_002695.2_cds_NP_309289.1_1181,412,264,335,333,1344
lcl|NC_002695.2_cds_NP_309290.1_1182,145,233,199,254,831
lcl|NC_002695.2_cds_NP_309291.1_1183,316,236,269,307,1128
lcl|NC_002695.2_cds_NP_309292.1_1184,305,284,306,377,1272
lcl|NC_002695.2_cds_NP_309293.1_1185,259,252,264,290,1065
lcl|NC_002695.2_cds_NP_309294.1_1186,122,110,91,91,414
lcl|NC_002695.2_cds_NP_309295.1_1187,320,386,285,335,1326
lcl|NC_002695.2_cds_NP_309296.1_1188,588,536,442,453,2019
lcl|NC_002695.2_cds_NP_309297.1_1189,673,604,569,578,2424
lcl|NC_002695.2_cds_NP_309298.1_1190,384,451,215,309,1359
lcl|NC_002695.2_cds_NP_309299.2_1191,504,516,276,315,1611
lcl|NC_002695.2_cds_NP_309300.1_1192,173,154,92,73,492
lcl|NC_002695.2_cds_NP_309301.1_1193,293,246,142,132,813
lcl|NC_002695.2_cds_NP_309302.2_1194,222,230,138,193,783
lcl|NC_002695.2_cds_NP_309303.2_1195,197,174,165,154,690
lcl|NC_002695.2_cds_NP_309304.1_1196,345,334,314,342,1335
lcl|NC_002695.2_cds_NP_309305.1_1197,647,582,638,656,2523
lcl|NC_002695.2_cds_NP_309306.3_1198,195,183,176,148,702
lcl|NC_002695.2_cds_NP_309307.1_1199,133,141,150,137,561
lcl|NC_002695.2_cds_NP_309308.1_1200,219,206,94,105,624
lcl|NC_002695.2_cds_NP_309309.2_1201,1066,868,867,1012,3813
lcl|NC_002695.2_cds_NP_309310.1_1202,470,462,288,400,1620
lcl|NC_002695.2_cds_NP_309311.1_1203,103,110,69,87,369
lcl|NC_002695.2_cds_NP_309312.2_1204,199,174,184,205,762
lcl|NC_002695.2_cds_NP_309313.1_1205,138,147,128,136,549
lcl|NC_002695.2_cds_NP_309314.3_1206,91,76,54,61,282
lcl|NC_002695.2_cds_NP_309315.1_1207,307,282,261,311,1161
lcl|NC_002695.2_cds_NP_309316.1_1208,616,573,644,726,2559
lcl|NC_002695.2_cds_NP_309317.2_1209,307,271,303,343,1224
lcl|NC_002695.2_cds_NP_309318.2_1210,235,252,217,250,954
lcl|NC_002695.2_cds_NP_309319.1_1211,190,201,141,176,708
lcl|NC_002695.2_cds_NP_309320.1_1212,159,146,163,189,657
lcl|NC_002695.2_cds_NP_309321.1_1213,298,390,282,341,1311
lcl|NC_002695.2_cds_NP_309322.1_1214,213,199,168,209,789
lcl|NC_002695.2_cds_NP_309323.1_1215,328,331,353,377,1389
lcl|NC_002695.2_cds_NP_309324.2_1216,247,234,213,248,942
lcl|NC_002695.2_cds_NP_309325.1_1217,217,369,172,229,987
lcl|NC_002695.2_cds_NP_309326.1_1218,321,293,258,331,1203
lcl|NC_002695.2_cds_NP_309327.1_1219,677,551,312,278,1818
lcl|NC_002695.2_cds_NP_309329.1_1220,82,80,69,66,297
lcl|NC_002695.2_cds_NP_309330.1_1221,432,363,256,335,1386
lcl|NC_002695.2_cds_NP_309331.1_1222,170,145,117,132,564
lcl|NC_002695.2_cds_NP_309332.1_1223,592,629,504,636,2361
lcl|NC_002695.2_cds_NP_309334.1_1224,345,294,425,475,1539
lcl|NC_002695.2_cds_NP_309335.1_1225,69,75,99,105,348
lcl|NC_002695.2_cds_NP_309336.2_1226,101,81,108,91,381
lcl|NC_002695.2_cds_NP_309338.1_1227,224,174,199,222,819
lcl|NC_002695.2_cds_NP_309339.2_1228,163,113,122,142,540
lcl|NC_002695.2_cds_NP_309340.1_1229,79,72,41,60,252
lcl|NC_002695.2_cds_NP_309341.1_1230,88,95,44,64,291
lcl|NC_002695.2_cds_NP_309343.1_1231,98,118,57,87,360
lcl|NC_002695.2_cds_NP_309344.2_1232,516,572,243,289,1620
lcl|NC_002695.2_cds_NP_309346.1_1233,65,85,56,70,276
lcl|NC_002695.2_cds_NP_309348.2_1234,154,169,203,173,699
lcl|NC_002695.2_cds_NP_309349.1_1235,78,62,82,81,303
lcl|NC_002695.2_cds_NP_309350.1_1236,83,70,75,93,321
lcl|NC_002695.2_cds_NP_309351.2_1237,413,366,470,455,1704
lcl|NC_002695.2_cds_NP_309352.1_1238,100,110,130,125,465
lcl|NC_002695.2_cds_NP_309353.1_1239,138,138,198,201,675
lcl|NC_002695.2_cds_NP_309354.1_1240,164,122,159,173,618
lcl|NC_002695.2_cds_NP_309357.1_1241,73,78,51,62,264
lcl|NC_002695.2_cds_NP_309360.1_1242,254,217,121,80,672
lcl|NC_002695.2_cds_NP_309363.2_1243,113,100,125,148,486
lcl|NC_002695.2_cds_NP_309364.1_1244,113,105,109,99,426
lcl|NC_002695.2_cds_NP_309365.1_1245,76,89,93,93,351
lcl|NC_002695.2_cds_NP_309366.1_1246,416,322,398,478,1614
lcl|NC_002695.2_cds_NP_309367.2_1247,206,187,237,228,858
lcl|NC_002695.2_cds_NP_309368.2_1248,84,75,88,95,342
lcl|NC_002695.2_cds_NP_309369.1_1249,75,79,96,80,330
lcl|NC_002695.2_cds_NP_309370.1_1250,139,97,117,115,468
lcl|NC_002695.2_cds_NP_309371.1_1251,303,261,306,339,1209
lcl|NC_002695.2_cds_NP_309372.1_1252,208,231,252,266,957
lcl|NC_002695.2_cds_NP_309373.2_1253,239,258,271,312,1080
lcl|NC_002695.2_cds_NP_309375.1_1254,194,166,203,211,774
lcl|NC_002695.2_cds_NP_309376.1_1255,248,273,322,300,1143
lcl|NC_002695.2_cds_NP_309377.1_1256,259,268,265,267,1059
lcl|NC_002695.2_cds_NP_309378.1_1257,142,146,145,149,582
lcl|NC_002695.2_cds_NP_309379.2_1258,272,252,290,344,1158
lcl|NC_002695.2_cds_NP_309380.1_1259,117,113,102,124,456
lcl|NC_002695.2_cds_NP_309381.1_1260,201,299,256,285,1041
lcl|NC_002695.2_cds_NP_309382.1_1261,128,143,147,161,579
lcl|NC_002695.2_cds_NP_309383.1_1262,151,133,139,153,576
lcl|NC_002695.2_cds_NP_309385.1_1263,80,84,74,71,309
lcl|NC_002695.2_cds_NP_309387.1_1264,535,476,470,610,2091
lcl|NC_002695.2_cds_NP_309389.2_1265,80,75,18,46,219
lcl|NC_002695.2_cds_YP_009502602.1_1266,116,77,64,79,336
lcl|NC_002695.2_cds_NP_309391.1_1267,76,39,40,40,195
lcl|NC_002695.2_cds_NP_309392.2_1268,60,36,48,36,180
lcl|NC_002695.2_cds_NP_309393.1_1269,57,87,57,72,273
lcl|NC_002695.2_cds_YP_009502603.1_1270,59,45,47,47,198
lcl|NC_002695.2_cds_NP_309397.1_1271,302,339,205,279,1125
lcl|NC_002695.2_cds_NP_309399.2_1272,73,67,70,84,294
lcl|NC_002695.2_cds_NP_309400.1_1273,65,65,81,65,276
lcl|NC_002695.2_cds_NP_309401.1_1274,136,151,88,84,459
lcl|NC_002695.2_cds_NP_309403.1_1275,122,125,117,146,510
lcl|NC_002695.2_cds_NP_309404.1_1276,143,143,150,188,624
lcl|NC_002695.2_cds_NP_309405.1_1277,62,59,45,68,234
lcl|NC_002695.2_cds_YP_009502604.1_1278,58,40,47,47,192
lcl|NC_002695.2_cds_NP_309407.1_1279,219,194,208,267,888
lcl|NC_002695.2_cds_NP_309408.1_1280,82,75,78,92,327
lcl|NC_002695.2_cds_NP_309409.2_1281,242,254,255,296,1047
lcl|NC_002695.2_cds_NP_309413.1_1282,280,320,290,343,1233
lcl|NC_002695.2_cds_NP_309414.1_1283,167,136,133,203,639
lcl|NC_002695.2_cds_NP_309415.1_1284,58,64,58,90,270
lcl|NC_002695.2_cds_NP_309416.1_1285,207,169,121,148,645
lcl|NC_002695.2_cds_YP_009502605.1_1286,124,124,128,125,501
lcl|NC_002695.2_cds_NP_309420.1_1287,113,94,108,111,426
lcl|NC_002695.2_cds_NP_309421.1_1288,64,54,26,39,183
lcl|NC_002695.2_cds_NP_309422.1_1289,172,197,244,260,873
lcl|NC_002695.2_cds_NP_309423.1_1290,676,544,754,876,2850
lcl|NC_002695.2_cds_NP_309424.1_1291,663,479,572,671,2385
lcl|NC_002695.2_cds_NP_309425.1_1292,216,200,224,266,906
lcl|NC_002695.2_cds_NP_309426.1_1293,245,240,258,328,1071
lcl|NC_002695.2_cds_NP_309428.1_1294,196,175,218,230,819
lcl|NC_002695.2_cds_NP_309429.1_1295,106,112,143,125,486
lcl|NC_002695.2_cds_NP_309430.1_1296,98,98,147,134,477
lcl|NC_002695.2_cds_NP_309431.1_1297,45,59,58,60,222
lcl|NC_002695.2_cds_NP_309432.1_1298,83,77,122,93,375
lcl|NC_002695.2_cds_NP_309433.1_1299,95,85,103,92,375
lcl|NC_002695.2_cds_NP_309434.3_1300,108,123,136,125,492
lcl|NC_002695.2_cds_NP_309435.1_1301,53,44,48,53,198
lcl|NC_002695.2_cds_NP_309436.1_1302,246,189,196,212,843
lcl|NC_002695.2_cds_NP_309437.2_1303,222,236,230,251,939
lcl|NC_002695.2_cds_NP_309438.1_1304,192,188,171,187,738
lcl|NC_002695.2_cds_NP_309439.1_1305,123,135,134,163,555
lcl|NC_002695.2_cds_NP_309440.4_1306,98,142,123,159,522
lcl|NC_002695.2_cds_NP_309441.1_1307,207,207,205,215,834
lcl|NC_002695.2_cds_NP_309442.1_1308,123,119,93,82,417
lcl|NC_002695.2_cds_NP_309443.1_1309,112,111,74,93,390
lcl|NC_002695.2_cds_NP_309444.1_1310,201,178,142,130,651
lcl|NC_002695.2_cds_NP_309446.1_1311,146,120,77,113,456
lcl|NC_002695.2_cds_NP_309447.1_1312,113,115,108,123,459
lcl|NC_002695.2_cds_NP_309448.1_1313,95,95,78,65,333
lcl|NC_002695.2_cds_NP_309449.1_1314,93,81,71,67,312
lcl|NC_002695.2_cds_NP_309450.1_1315,129,132,128,145,534
lcl|NC_002695.2_cds_NP_309451.3_1316,346,388,353,395,1482
lcl|NC_002695.2_cds_NP_309452.1_1317,265,380,263,250,1158
lcl|NC_002695.2_cds_NP_309453.2_1318,407,346,367,383,1503
lcl|NC_002695.2_cds_NP_309454.3_1319,494,643,654,723,2514
lcl|NC_002695.2_cds_NP_309455.1_1320,45,67,55,61,228
lcl|NC_002695.2_cds_NP_309456.2_1321,109,77,75,114,375
lcl|NC_002695.2_cds_NP_309459.1_1322,218,217,229,257,921
lcl|NC_002695.2_cds_NP_309460.1_1323,281,254,239,279,1053
lcl|NC_002695.2_cds_NP_309461.1_1324,172,137,134,133,576
lcl|NC_002695.2_cds_NP_309462.1_1325,116,162,146,143,567
lcl|NC_002695.2_cds_NP_309463.2_1326,23,48,19,24,114
lcl|NC_002695.2_cds_NP_309464.1_1327,268,265,296,290,1119
lcl|NC_002695.2_cds_NP_309465.3_1328,76,63,53,63,255
lcl|NC_002695.2_cds_NP_309466.1_1329,69,59,56,62,246
lcl|NC_002695.2_cds_NP_309467.1_1330,253,238,294,262,1047
lcl|NC_002695.2_cds_NP_309468.1_1331,171,124,133,133,561
lcl|NC_002695.2_cds_NP_309469.1_1332,178,153,170,147,648
lcl|NC_002695.2_cds_NP_309470.2_1333,196,339,307,367,1209
lcl|NC_002695.2_cds_NP_309471.1_1334,145,149,141,150,585
lcl|NC_002695.2_cds_NP_309472.1_1335,163,147,145,193,648
lcl|NC_002695.2_cds_NP_309473.1_1336,205,214,227,278,924
lcl|NC_002695.2_cds_NP_309474.1_1337,268,450,384,434,1536
lcl|NC_002695.2_cds_NP_309475.1_1338,138,79,98,102,417
lcl|NC_002695.2_cds_NP_309476.1_1339,94,48,81,71,294
lcl|NC_002695.2_cds_NP_309477.1_1340,162,153,158,187,660
lcl|NC_002695.2_cds_NP_309478.1_1341,111,84,117,105,417
lcl|NC_002695.2_cds_NP_309479.1_1342,104,87,95,119,405
lcl|NC_002695.2_cds_NP_309480.1_1343,180,136,193,187,696
lcl|NC_002695.2_cds_NP_309481.1_1344,320,262,324,300,1206
lcl|NC_002695.2_cds_NP_309482.1_1345,171,136,201,248,756
lcl|NC_002695.2_cds_NP_309483.1_1346,206,154,217,206,783
lcl|NC_002695.2_cds_NP_309484.1_1347,160,168,185,186,699
lcl|NC_002695.2_cds_NP_309485.3_1348,259,244,280,315,1098
lcl|NC_002695.2_cds_NP_309486.1_1349,258,168,250,266,942
lcl|NC_002695.2_cds_NP_309487.1_1350,436,356,406,446,1644
lcl|NC_002695.2_cds_NP_309488.1_1351,265,203,235,251,954
lcl|NC_002695.2_cds_NP_309489.1_1352,804,604,895,883,3186
lcl|NC_002695.2_cds_NP_309491.1_1353,240,222,213,285,960
lcl|NC_002695.2_cds_NP_309492.3_1354,161,159,145,159,624
lcl|NC_002695.2_cds_NP_309493.1_1355,134,130,120,138,522
lcl|NC_002695.2_cds_NP_309494.1_1356,48,32,56,38,174
lcl|NC_002695.2_cds_NP_309495.3_1357,245,254,241,301,1041
lcl|NC_002695.2_cds_NP_309496.1_1358,207,224,241,282,954
lcl|NC_002695.2_cds_NP_309497.1_1359,214,206,228,282,930
lcl|NC_002695.2_cds_NP_309498.1_1360,182,176,163,214,735
lcl|NC_002695.2_cds_NP_309499.1_1361,72,52,51,62,237
lcl|NC_002695.2_cds_NP_309500.1_1362,288,294,303,357,1242
lcl|NC_002695.2_cds_NP_309501.1_1363,188,213,179,230,810
lcl|NC_002695.2_cds_NP_309502.1_1364,270,238,236,279,1023
lcl|NC_002695.2_cds_NP_309503.1_1365,149,148,160,185,642
lcl|NC_002695.2_cds_NP_309504.1_1366,217,239,271,278,1005
lcl|NC_002695.2_cds_NP_309505.1_1367,188,201,198,211,798
lcl|NC_002695.2_cds_NP_309506.1_1368,287,395,370,382,1434
lcl|NC_002695.2_cds_NP_309507.1_1369,586,511,550,543,2190
lcl|NC_002695.2_cds_NP_309508.3_1370,94,83,91,92,360
lcl|NC_002695.2_cds_NP_309509.1_1371,86,103,89,100,378
lcl|NC_002695.2_cds_NP_309510.1_1372,154,127,178,183,642
lcl|NC_002695.2_cds_NP_309511.1_1373,189,199,207,230,825
lcl|NC_002695.2_cds_NP_309512.1_1374,246,234,237,309,1026
lcl|NC_002695.2_cds_NP_309513.2_1375,147,139,121,136,543
lcl|NC_002695.2_cds_NP_309514.1_1376,330,293,326,356,1305
lcl|NC_002695.2_cds_NP_309515.1_1377,133,120,120,167,540
lcl|NC_002695.2_cds_NP_309516.3_1378,187,161,176,172,696
lcl|NC_002695.2_cds_NP_309517.1_1379,80,56,60,62,258
lcl|NC_002695.2_cds_NP_309518.2_1380,231,218,256,255,960
lcl|NC_002695.2_cds_NP_309519.2_1381,814,765,919,997,3495
lcl|NC_002695.2_cds_NP_309520.1_1382,209,340,256,269,1074
lcl|NC_002695.2_cds_NP_309521.1_1383,256,293,305,346,1200
lcl|NC_002695.2_cds_NP_309522.2_1384,163,152,178,209,702
lcl|NC_002695.2_cds_NP_309523.2_1385,273,328,279,359,1239
lcl|NC_002695.2_cds_NP_309524.1_1386,185,240,217,270,912
lcl|NC_002695.2_cds_NP_309525.1_1387,199,202,188,233,822
lcl|NC_002695.2_cds_NP_309526.1_1388,295,216,258,278,1047
lcl|NC_002695.2_cds_NP_309527.1_1389,159,235,180,221,795
lcl|NC_002695.2_cds_NP_309528.1_1390,370,242,244,263,1119
lcl|NC_002695.2_cds_NP_309529.1_1391,89,54,60,67,270
lcl|NC_002695.2_cds_NP_309530.2_1392,93,85,81,86,345
lcl|NC_002695.2_cds_NP_309531.2_1393,163,137,100,116,516
lcl|NC_002695.2_cds_NP_309532.1_1394,60,55,56,60,231
lcl|NC_002695.2_cds_NP_309533.1_1395,165,109,104,99,477
lcl|NC_002695.2_cds_NP_309534.1_1396,103,82,62,77,324
lcl|NC_002695.2_cds_NP_309535.1_1397,105,96,101,124,426
lcl|NC_002695.2_cds_NP_309536.1_1398,270,201,241,326,1038
lcl|NC_002695.2_cds_NP_309537.2_1399,103,80,95,145,423
lcl|NC_002695.2_cds_NP_309538.1_1400,200,137,162,218,717
lcl|NC_002695.2_cds_NP_309539.1_1401,79,71,59,109,318
lcl|NC_002695.2_cds_NP_309540.1_1402,74,66,60,103,303
lcl|NC_002695.2_cds_NP_309541.1_1403,95,73,65,85,318
lcl|NC_002695.2_cds_NP_309542.1_1404,94,82,54,88,318
lcl|NC_002695.2_cds_NP_309543.1_1405,122,96,99,121,438
lcl|NC_002695.2_cds_NP_309544.1_1406,69,44,34,45,192
lcl|NC_002695.2_cds_NP_309545.1_1407,161,139,123,165,588
lcl|NC_002695.2_cds_YP_009502606.1_1408,18,37,15,35,105
lcl|NC_002695.2_cds_NP_309547.1_1409,61,40,52,60,213
lcl|NC_002695.2_cds_NP_309549.1_1410,251,234,274,291,1050
lcl|NC_002695.2_cds_NP_309550.1_1411,88,91,84,112,375
lcl|NC_002695.2_cds_NP_309551.1_1412,237,192,156,237,822
lcl|NC_002695.2_cds_YP_009502607.1_1413,34,30,26,57,147
lcl|NC_002695.2_cds_YP_009502608.1_1414,31,46,32,59,168
lcl|NC_002695.2_cds_NP_309554.1_1415,467,420,463,588,1938
lcl|NC_002695.2_cds_NP_309555.1_1416,51,47,37,48,183
lcl|NC_002695.2_cds_NP_309556.1_1417,63,58,62,87,270
lcl|NC_002695.2_cds_NP_309557.1_1418,51,48,46,71,216
lcl|NC_002695.2_cds_NP_309558.1_1419,95,88,61,101,345
lcl|NC_002695.2_cds_NP_309559.1_1420,130,112,125,167,534
lcl|NC_002695.2_cds_NP_309560.1_1421,169,137,115,149,570
lcl|NC_002695.2_cds_YP_009502609.1_1422,28,48,30,41,147
lcl|NC_002695.2_cds_NP_309561.1_1423,112,98,122,136,468
lcl|NC_002695.2_cds_NP_309562.1_1424,44,39,62,62,207
lcl|NC_002695.2_cds_NP_309563.1_1425,58,65,45,57,225
lcl|NC_002695.2_cds_NP_309565.1_1426,24,61,24,32,141
lcl|NC_002695.2_cds_NP_309566.2_1427,18,30,12,30,90
lcl|NC_002695.2_cds_NP_309567.1_1428,75,83,93,115,366
lcl|NC_002695.2_cds_NP_309568.1_1429,153,101,137,173,564
lcl|NC_002695.2_cds_NP_309569.1_1430,349,352,412,549,1662
lcl|NC_002695.2_cds_NP_309570.1_1431,386,389,523,640,1938
lcl|NC_002695.2_cds_YP_009502610.1_1432,60,36,50,76,222
lcl|NC_002695.2_cds_NP_309571.1_1433,587,519,596,800,2502
lcl|NC_002695.2_cds_NP_309572.1_1434,70,76,73,108,327
lcl|NC_002695.2_cds_NP_309573.1_1435,75,72,80,124,351
lcl|NC_002695.2_cds_NP_309574.1_1436,96,93,105,153,447
lcl|NC_002695.2_cds_NP_309575.1_1437,59,79,88,119,345
lcl|NC_002695.2_cds_NP_309576.1_1438,172,163,171,211,717
lcl|NC_002695.2_cds_NP_309577.1_1439,83,77,85,130,375
lcl|NC_002695.2_cds_NP_309578.2_1440,46,43,42,79,210
lcl|NC_002695.2_cds_NP_304285.1_1441,779,606,771,1087,3243
lcl|NC_002695.2_cds_NP_309581.1_1442,70,75,73,124,342
lcl|NC_002695.2_cds_NP_309582.1_1443,147,146,158,248,699
lcl|NC_002695.2_cds_NP_309583.1_1444,96,54,52,53,255
lcl|NC_002695.2_cds_NP_309584.1_1445,277,213,184,205,879
lcl|NC_002695.2_cds_NP_309585.1_1446,150,159,196,233,738
lcl|NC_002695.2_cds_NP_309586.2_1447,49,41,44,52,186
lcl|NC_002695.2_cds_YP_009502611.1_1448,23,32,14,21,90
lcl|NC_002695.2_cds_NP_309587.1_1449,714,802,355,478,2349
lcl|NC_002695.2_cds_NP_309588.1_1450,1265,1058,444,635,3402
lcl|NC_002695.2_cds_NP_304296.1_1451,114,158,95,83,450
lcl|NC_002695.2_cds_NP_309591.1_1452,215,194,215,282,906
lcl|NC_002695.2_cds_NP_309592.1_1453,42,35,39,46,162
lcl|NC_002695.2_cds_NP_309594.1_1454,113,56,63,44,276
lcl|NC_002695.2_cds_NP_309595.1_1455,491,322,301,248,1362
lcl|NC_002695.2_cds_NP_309597.3_1456,174,254,217,219,864
lcl|NC_002695.2_cds_NP_309598.1_1457,297,262,277,301,1137
lcl|NC_002695.2_cds_NP_309599.1_1458,324,291,261,351,1227
lcl|NC_002695.2_cds_NP_309600.2_1459,255,264,286,317,1122
lcl|NC_002695.2_cds_NP_309601.1_1460,351,245,296,338,1230
lcl|NC_002695.2_cds_NP_309603.1_1461,169,225,176,174,744
lcl|NC_002695.2_cds_NP_309604.1_1462,41,52,52,53,198
lcl|NC_002695.2_cds_NP_309605.1_1463,55,53,36,42,186
lcl|NC_002695.2_cds_NP_309606.1_1464,61,49,36,46,192
lcl|NC_002695.2_cds_NP_309607.1_1465,92,56,43,52,243
lcl|NC_002695.2_cds_NP_309608.1_1466,92,64,66,78,300
lcl|NC_002695.2_cds_NP_309609.2_1467,558,431,465,679,2133
lcl|NC_002695.2_cds_NP_309613.1_1468,93,35,56,68,252
lcl|NC_002695.2_cds_NP_309614.1_1469,102,68,106,135,411
lcl|NC_002695.2_cds_NP_309615.1_1470,78,47,56,92,273
lcl|NC_002695.2_cds_NP_309616.3_1471,71,55,37,62,225
lcl|NC_002695.2_cds_NP_309617.1_1472,335,235,286,302,1158
lcl|NC_002695.2_cds_NP_309618.2_1473,133,121,141,178,573
lcl|NC_002695.2_cds_NP_309619.2_1474,273,233,313,357,1176
lcl|NC_002695.2_cds_NP_309620.1_1475,92,56,81,110,339
lcl|NC_002695.2_cds_NP_309621.1_1476,80,64,70,83,297
lcl|NC_002695.2_cds_NP_309622.1_1477,119,79,106,137,441
lcl|NC_002695.2_cds_NP_309624.1_1478,100,60,93,104,357
lcl|NC_002695.2_cds_NP_309625.1_1479,419,367,397,479,1662
lcl|NC_002695.2_cds_NP_309626.1_1480,78,56,65,83,282
lcl|NC_002695.2_cds_NP_309628.1_1481,370,347,344,400,1461
lcl|NC_002695.2_cds_NP_309629.1_1482,178,176,146,172,672
lcl|NC_002695.2_cds_NP_309630.1_1483,348,302,372,349,1371
lcl|NC_002695.2_cds_NP_309631.1_1484,138,137,199,168,642
lcl|NC_002695.2_cds_NP_309632.2_1485,264,252,284,307,1107
lcl|NC_002695.2_cds_NP_309633.1_1486,113,116,109,124,462
lcl|NC_002695.2_cds_NP_309634.3_1487,178,142,174,160,654
lcl|NC_002695.2_cds_NP_309635.1_1488,331,291,295,334,1251
lcl|NC_002695.2_cds_NP_309636.1_1489,379,268,246,250,1143
lcl|NC_002695.2_cds_NP_309637.1_1490,75,50,56,56,237
lcl|NC_002695.2_cds_NP_309638.1_1491,260,183,182,200,825
lcl|NC_002695.2_cds_NP_309639.1_1492,189,141,173,199,702
lcl|NC_002695.2_cds_NP_309640.1_1493,90,61,57,95,303
lcl|NC_002695.2_cds_NP_309641.1_1494,74,120,60,79,333
lcl|NC_002695.2_cds_NP_309642.1_1495,524,460,220,323,1527
lcl|NC_002695.2_cds_NP_309643.1_1496,121,104,117,114,456
lcl|NC_002695.2_cds_NP_309644.1_1497,54,35,42,40,171
lcl|NC_002695.2_cds_NP_309645.1_1498,77,63,68,83,291
lcl|NC_002695.2_cds_NP_309646.1_1499,93,75,98,97,363
lcl|NC_002695.2_cds_YP_009502612.1_1500,33,41,33,34,141
lcl|NC_002695.2_cds_NP_309647.1_1501,203,160,144,183,690
lcl|NC_002695.2_cds_NP_309648.2_1502,76,79,56,95,306
lcl|NC_002695.2_cds_NP_309649.1_1503,125,114,115,123,477
lcl|NC_002695.2_cds_NP_309650.1_1504,128,99,118,117,462
lcl|NC_002695.2_cds_NP_309651.1_1505,42,38,52,51,183
lcl|NC_002695.2_cds_NP_309652.1_1506,92,74,67,61,294
lcl|NC_002695.2_cds_NP_309653.2_1507,154,125,68,64,411
lcl|NC_002695.2_cds_NP_309654.1_1508,63,62,33,49,207
lcl|NC_002695.2_cds_NP_309656.1_1509,150,109,123,164,546
lcl|NC_002695.2_cds_NP_309657.1_1510,469,412,477,568,1926
lcl|NC_002695.2_cds_NP_309658.1_1511,58,36,48,65,207
lcl|NC_002695.2_cds_NP_309659.1_1512,347,316,424,515,1602
lcl|NC_002695.2_cds_NP_309660.1_1513,276,242,380,422,1320
lcl|NC_002695.2_cds_NP_309661.1_1514,74,60,102,97,333
lcl|NC_002695.2_cds_NP_309662.1_1515,234,214,280,298,1026
lcl|NC_002695.2_cds_NP_309663.1_1516,95,77,97,130,399
lcl|NC_002695.2_cds_NP_309664.1_1517,69,80,91,114,354
lcl|NC_002695.2_cds_NP_309665.1_1518,147,113,137,182,579
lcl|NC_002695.2_cds_NP_309666.1_1519,83,98,94,121,396
lcl|NC_002695.2_cds_NP_309667.1_1520,179,129,197,236,741
lcl|NC_002695.2_cds_NP_309668.1_1521,104,90,103,126,423
lcl|NC_002695.2_cds_NP_309669.1_1522,85,105,103,142,435
lcl|NC_002695.2_cds_NP_309670.1_1523,616,445,628,861,2550
lcl|NC_002695.2_cds_NP_309671.1_1524,64,76,79,111,330
lcl|NC_002695.2_cds_NP_309672.1_1525,161,148,172,218,699
lcl|NC_002695.2_cds_NP_309673.1_1526,138,165,194,247,744
lcl|NC_002695.2_cds_NP_309674.2_1527,111,124,150,188,573
lcl|NC_002695.2_cds_NP_309675.1_1528,817,673,858,1051,3399
lcl|NC_002695.2_cds_NP_309676.1_1529,121,145,149,185,600
lcl|NC_002695.2_cds_NP_309677.1_1530,785,537,778,816,2916
lcl|NC_002695.2_cds_NP_309678.1_1531,166,141,120,155,582
lcl|NC_002695.2_cds_NP_309679.1_1532,291,218,182,200,891
lcl|NC_002695.2_cds_NP_309680.1_1533,169,137,97,104,507
lcl|NC_002695.2_cds_NP_309681.1_1534,183,128,86,104,501
lcl|NC_002695.2_cds_NP_309682.1_1535,60,36,36,51,183
lcl|NC_002695.2_cds_NP_309683.2_1536,209,188,133,139,669
lcl|NC_002695.2_cds_NP_309684.1_1537,72,57,50,70,249
lcl|NC_002695.2_cds_NP_309685.1_1538,103,81,106,91,381
lcl|NC_002695.2_cds_NP_309686.1_1539,69,75,99,105,348
lcl|NC_002695.2_cds_NP_309687.1_1540,345,294,425,475,1539
lcl|NC_002695.2_cds_NP_309689.1_1541,474,385,322,304,1485
lcl|NC_002695.2_cds_NP_309690.1_1542,302,238,201,213,954
lcl|NC_002695.2_cds_NP_309691.1_1543,171,155,134,125,585
lcl|NC_002695.2_cds_NP_309692.1_1544,75,75,79,98,327
lcl|NC_002695.2_cds_NP_309693.2_1545,220,189,209,270,888
lcl|NC_002695.2_cds_NP_309695.1_1546,83,69,54,61,267
lcl|NC_002695.2_cds_NP_309696.1_1547,215,194,191,213,813
lcl|NC_002695.2_cds_NP_309697.1_1548,187,155,167,187,696
lcl|NC_002695.2_cds_NP_309698.1_1549,104,109,65,91,369
lcl|NC_002695.2_cds_NP_309699.1_1550,131,98,89,84,402
lcl|NC_002695.2_cds_NP_309700.2_1551,35,46,34,44,159
lcl|NC_002695.2_cds_NP_309701.2_1552,91,74,58,71,294
lcl|NC_002695.2_cds_NP_309702.1_1553,160,154,157,189,660
lcl|NC_002695.2_cds_NP_309703.5_1554,123,113,97,114,447
lcl|NC_002695.2_cds_NP_309704.2_1555,304,230,175,203,912
lcl|NC_002695.2_cds_NP_309705.1_1556,94,123,97,106,420
lcl|NC_002695.2_cds_NP_309706.1_1557,315,308,288,358,1269
lcl|NC_002695.2_cds_NP_309707.1_1558,91,162,124,154,531
lcl|NC_002695.2_cds_NP_309708.1_1559,290,441,403,408,1542
lcl|NC_002695.2_cds_NP_309709.1_1560,172,178,171,199,720
lcl|NC_002695.2_cds_NP_309710.1_1561,408,361,366,398,1533
lcl|NC_002695.2_cds_NP_309711.1_1562,288,282,332,397,1299
lcl|NC_002695.2_cds_NP_309712.2_1563,216,239,268,348,1071
lcl|NC_002695.2_cds_NP_309713.2_1564,322,500,409,506,1737
lcl|NC_002695.2_cds_NP_309715.2_1565,200,234,239,242,915
lcl|NC_002695.2_cds_NP_309714.2_1566,153,142,138,179,612
lcl|NC_002695.2_cds_NP_309716.2_1567,225,191,209,263,888
lcl|NC_002695.2_cds_NP_309717.1_1568,79,76,78,94,327
lcl|NC_002695.2_cds_NP_309719.1_1569,40,77,55,83,255
lcl|NC_002695.2_cds_NP_309720.1_1570,552,431,479,509,1971
lcl|NC_002695.2_cds_NP_309721.1_1571,205,203,231,216,855
lcl|NC_002695.2_cds_NP_309723.1_1572,156,143,178,168,645
lcl|NC_002695.2_cds_NP_309724.1_1573,168,181,221,189,759
lcl|NC_002695.2_cds_NP_309725.1_1574,177,274,263,267,981
lcl|NC_002695.2_cds_NP_309726.1_1575,228,247,288,260,1023
lcl|NC_002695.2_cds_YP_009502613.1_1576,50,86,41,24,201
lcl|NC_002695.2_cds_NP_304434.1_1577,417,284,374,383,1458
lcl|NC_002695.2_cds_NP_309730.2_1578,371,331,353,364,1419
lcl|NC_002695.2_cds_NP_309731.1_1579,151,143,159,180,633
lcl|NC_002695.2_cds_NP_309732.4_1580,258,245,277,291,1071
lcl|NC_002695.2_cds_NP_309735.1_1581,300,234,267,291,1092
lcl|NC_002695.2_cds_NP_309736.1_1582,144,147,137,157,585
lcl|NC_002695.2_cds_NP_309737.1_1583,56,75,65,83,279
lcl|NC_002695.2_cds_NP_309738.3_1584,276,470,428,479,1653
lcl|NC_002695.2_cds_NP_309739.2_1585,216,263,273,262,1014
lcl|NC_002695.2_cds_NP_309740.1_1586,188,207,204,253,852
lcl|NC_002695.2_cds_NP_309741.1_1587,166,138,169,151,624
lcl|NC_002695.2_cds_NP_309742.1_1588,308,271,320,358,1257
lcl|NC_002695.2_cds_NP_309743.1_1589,278,232,275,298,1083
lcl|NC_002695.2_cds_NP_309744.1_1590,179,190,222,243,834
lcl|NC_002695.2_cds_NP_309745.1_1591,81,127,90,95,393
lcl|NC_002695.2_cds_NP_309746.1_1592,213,218,168,211,810
lcl|NC_002695.2_cds_NP_309747.1_1593,208,205,200,242,855
lcl|NC_002695.2_cds_YP_009502614.1_1594,22,25,28,33,108
lcl|NC_002695.2_cds_YP_009502615.1_1595,21,24,29,34,108
lcl|NC_002695.2_cds_NP_309748.1_1596,229,333,265,274,1101
lcl|NC_002695.2_cds_NP_309749.1_1597,83,42,46,60,231
lcl|NC_002695.2_cds_NP_309750.3_1598,160,164,167,229,720
lcl|NC_002695.2_cds_NP_309751.1_1599,89,82,81,102,354
lcl|NC_002695.2_cds_NP_309752.3_1600,362,346,323,400,1431
lcl|NC_002695.2_cds_NP_309753.1_1601,174,139,160,178,651
lcl|NC_002695.2_cds_NP_309754.1_1602,427,410,461,499,1797
lcl|NC_002695.2_cds_NP_309755.1_1603,240,407,345,400,1392
lcl|NC_002695.2_cds_NP_309756.1_1604,904,783,1005,1052,3744
lcl|NC_002695.2_cds_NP_309757.1_1605,389,320,395,435,1539
lcl|NC_002695.2_cds_NP_309758.1_1606,162,153,187,209,711
lcl|NC_002695.2_cds_NP_309759.1_1607,118,186,173,201,678
lcl|NC_002695.2_cds_NP_309761.1_1608,214,225,195,209,843
lcl|NC_002695.2_cds_NP_309762.1_1609,111,135,94,119,459
lcl|NC_002695.2_cds_NP_309763.3_1610,225,244,209,267,945
lcl|NC_002695.2_cds_NP_309764.1_1611,243,276,222,273,1014
lcl|NC_002695.2_cds_NP_309765.1_1612,250,232,183,244,909
lcl|NC_002695.2_cds_NP_309766.1_1613,136,82,94,102,414
lcl|NC_002695.2_cds_NP_309767.1_1614,175,180,118,145,618
lcl|NC_002695.2_cds_NP_309768.1_1615,679,635,695,667,2676
lcl|NC_002695.2_cds_NP_309769.1_1616,135,201,138,174,648
lcl|NC_002695.2_cds_NP_309770.2_1617,489,388,400,400,1677
lcl|NC_002695.2_cds_NP_309771.1_1618,201,291,210,219,921
lcl|NC_002695.2_cds_NP_309772.1_1619,168,265,203,273,909
lcl|NC_002695.2_cds_NP_309773.1_1620,244,246,242,282,1014
lcl|NC_002695.2_cds_NP_309774.1_1621,237,248,244,276,1005
lcl|NC_002695.2_cds_NP_309775.2_1622,84,90,70,86,330
lcl|NC_002695.2_cds_NP_309776.1_1623,318,388,358,397,1461
lcl|NC_002695.2_cds_NP_309777.1_1624,339,385,265,265,1254
lcl|NC_002695.2_cds_NP_309778.2_1625,73,79,66,79,297
lcl|NC_002695.2_cds_NP_309779.1_1626,186,140,199,195,720
lcl|NC_002695.2_cds_NP_309780.1_1627,100,104,85,110,399
lcl|NC_002695.2_cds_NP_309781.1_1628,115,174,121,130,540
lcl|NC_002695.2_cds_NP_309782.1_1629,152,224,178,190,744
lcl|NC_002695.2_cds_NP_309783.1_1630,151,172,140,176,639
lcl|NC_002695.2_cds_NP_309784.1_1631,348,259,249,275,1131
lcl|NC_002695.2_cds_NP_309785.1_1632,75,51,57,66,249
lcl|NC_002695.2_cds_NP_309786.1_1633,751,496,599,626,2472
lcl|NC_002695.2_cds_NP_309787.1_1634,55,54,40,43,192
lcl|NC_002695.2_cds_NP_309788.1_1635,65,54,32,38,189
lcl|NC_002695.2_cds_NP_309789.1_1636,78,71,42,43,234
lcl|NC_002695.2_cds_NP_309790.1_1637,126,120,79,83,408
lcl|NC_002695.2_cds_NP_309791.1_1638,72,41,51,55,219
lcl|NC_002695.2_cds_YP_009502616.1_1639,83,80,68,69,300
lcl|NC_002695.2_cds_NP_309792.1_1640,136,88,90,94,408
lcl|NC_002695.2_cds_NP_309793.1_1641,62,48,47,71,228
lcl|NC_002695.2_cds_NP_309794.1_1642,159,129,110,154,552
lcl|NC_002695.2_cds_NP_309795.1_1643,308,209,235,289,1041
lcl|NC_002695.2_cds_NP_309796.2_1644,100,83,103,137,423
lcl|NC_002695.2_cds_YP_009502617.1_1645,171,111,137,163,582
lcl|NC_002695.2_cds_YP_009502618.1_1646,49,37,29,50,165
lcl|NC_002695.2_cds_NP_309799.1_1647,237,189,148,185,759
lcl|NC_002695.2_cds_NP_309800.1_1648,61,44,50,58,213
lcl|NC_002695.2_cds_NP_309801.1_1649,65,85,38,70,258
lcl|NC_002695.2_cds_NP_309802.1_1650,68,59,84,68,279
lcl|NC_002695.2_cds_NP_309803.1_1651,236,241,276,294,1047
lcl|NC_002695.2_cds_NP_309804.1_1652,91,89,74,106,360
lcl|NC_002695.2_cds_NP_309805.1_1653,158,128,91,154,531
lcl|NC_002695.2_cds_NP_309806.2_1654,51,47,46,54,198
lcl|NC_002695.2_cds_NP_309807.1_1655,265,228,241,325,1059
lcl|NC_002695.2_cds_NP_309808.1_1656,440,388,473,553,1854
lcl|NC_002695.2_cds_NP_309809.1_1657,53,46,45,72,216
lcl|NC_002695.2_cds_NP_309810.1_1658,94,86,63,102,345
lcl|NC_002695.2_cds_NP_309811.1_1659,129,109,126,170,534
lcl|NC_002695.2_cds_NP_309812.1_1660,169,137,115,149,570
lcl|NC_002695.2_cds_YP_009502619.1_1661,28,48,30,41,147
lcl|NC_002695.2_cds_NP_309813.1_1662,115,92,124,137,468
lcl|NC_002695.2_cds_NP_309814.1_1663,41,35,56,54,186
lcl|NC_002695.2_cds_NP_309815.1_1664,76,52,54,46,228
lcl|NC_002695.2_cds_NP_309816.1_1665,75,83,93,115,366
lcl|NC_002695.2_cds_NP_309818.1_1666,153,102,136,173,564
lcl|NC_002695.2_cds_NP_309819.1_1667,349,352,412,549,1662
lcl|NC_002695.2_cds_NP_309820.1_1668,387,388,523,640,1938
lcl|NC_002695.2_cds_NP_304527.1_1669,60,35,51,76,222
lcl|NC_002695.2_cds_NP_309822.1_1670,593,531,622,834,2580
lcl|NC_002695.2_cds_NP_309823.1_1671,69,74,74,110,327
lcl|NC_002695.2_cds_NP_309824.1_1672,76,67,82,126,351
lcl|NC_002695.2_cds_NP_309825.1_1673,97,89,107,154,447
lcl|NC_002695.2_cds_NP_309826.1_1674,60,79,88,118,345
lcl|NC_002695.2_cds_NP_309827.2_1675,174,162,174,207,717
lcl|NC_002695.2_cds_NP_309828.1_1676,83,77,85,130,375
lcl|NC_002695.2_cds_NP_309829.2_1677,46,43,42,79,210
lcl|NC_002695.2_cds_NP_309830.1_1678,736,577,728,1040,3081
lcl|NC_002695.2_cds_NP_309831.1_1679,69,77,73,123,342
lcl|NC_002695.2_cds_NP_309832.1_1680,102,89,89,158,438
lcl|NC_002695.2_cds_NP_309833.1_1681,805,675,914,1083,3477
lcl|NC_002695.2_cds_NP_309834.1_1682,127,146,141,186,600
lcl|NC_002695.2_cds_NP_309835.1_1683,335,196,323,460,1314
lcl|NC_002695.2_cds_NP_309836.1_1684,80,52,51,87,270
lcl|NC_002695.2_cds_NP_309839.1_1685,427,342,280,277,1326
lcl|NC_002695.2_cds_NP_309841.1_1686,291,275,139,207,912
lcl|NC_002695.2_cds_NP_309842.1_1687,183,176,79,132,570
lcl|NC_002695.2_cds_NP_304549.1_1688,67,59,60,72,258
lcl|NC_002695.2_cds_NP_309845.1_1689,345,294,425,475,1539
lcl|NC_002695.2_cds_NP_309846.1_1690,69,75,99,105,348
lcl|NC_002695.2_cds_NP_309847.1_1691,103,81,106,91,381
lcl|NC_002695.2_cds_NP_309848.1_1692,106,73,53,47,279
lcl|NC_002695.2_cds_NP_304556.1_1693,46,40,23,38,147
lcl|NC_002695.2_cds_NP_309851.1_1694,197,184,139,128,648
lcl|NC_002695.2_cds_NP_309852.1_1695,192,167,94,138,591
lcl|NC_002695.2_cds_NP_309856.1_1696,164,137,103,103,507
lcl|NC_002695.2_cds_NP_309857.1_1697,183,102,99,117,501
lcl|NC_002695.2_cds_NP_309858.2_1698,58,31,37,54,180
lcl|NC_002695.2_cds_NP_309859.1_1699,183,184,220,220,807
lcl|NC_002695.2_cds_NP_309860.1_1700,288,255,319,332,1194
lcl|NC_002695.2_cds_NP_309861.2_1701,314,327,332,386,1359
lcl|NC_002695.2_cds_NP_309862.1_1702,358,350,437,451,1596
lcl|NC_002695.2_cds_NP_309863.1_1703,341,365,446,411,1563
lcl|NC_002695.2_cds_NP_309864.1_1704,12,13,8,12,45
lcl|NC_002695.2_cds_NP_309865.1_1705,219,183,228,252,882
lcl|NC_002695.2_cds_NP_309866.4_1706,158,158,149,156,621
lcl|NC_002695.2_cds_NP_309867.1_1707,352,489,341,402,1584
lcl|NC_002695.2_cds_NP_309868.1_1708,197,203,205,268,873
lcl|NC_002695.2_cds_NP_309869.1_1709,156,133,129,173,591
lcl|NC_002695.2_cds_NP_309870.1_1710,195,171,201,192,759
lcl|NC_002695.2_cds_NP_309871.1_1711,291,229,222,308,1050
lcl|NC_002695.2_cds_NP_309872.1_1712,80,54,59,59,252
lcl|NC_002695.2_cds_NP_309873.1_1713,690,557,622,729,2598
lcl|NC_002695.2_cds_NP_309874.1_1714,256,249,234,236,975
lcl|NC_002695.2_cds_YP_009502620.1_1715,26,39,27,37,129
lcl|NC_002695.2_cds_NP_304581.1_1716,54,36,38,40,168
lcl|NC_002695.2_cds_NP_309876.1_1717,652,611,663,750,2676
lcl|NC_002695.2_cds_NP_309877.1_1718,152,143,146,150,591
lcl|NC_002695.2_cds_NP_309878.1_1719,178,202,171,214,765
lcl|NC_002695.2_cds_NP_309879.1_1720,62,95,63,89,309
lcl|NC_002695.2_cds_NP_309880.1_1721,296,266,282,326,1170
lcl|NC_002695.2_cds_NP_309881.2_1722,159,211,198,230,798
lcl|NC_002695.2_cds_NP_309882.2_1723,98,69,65,95,327
lcl|NC_002695.2_cds_NP_309883.1_1724,50,52,48,69,219
lcl|NC_002695.2_cds_NP_309884.1_1725,200,180,184,186,750
lcl|NC_002695.2_cds_YP_009502621.1_1726,45,47,41,41,174
lcl|NC_002695.2_cds_NP_309885.1_1727,513,512,464,497,1986
lcl|NC_002695.2_cds_NP_309886.1_1728,472,442,515,506,1935
lcl|NC_002695.2_cds_NP_309887.2_1729,278,275,308,267,1128
lcl|NC_002695.2_cds_NP_309888.1_1730,170,199,212,208,789
lcl|NC_002695.2_cds_NP_309889.1_1731,157,137,133,140,567
lcl|NC_002695.2_cds_NP_309890.1_1732,305,243,267,307,1122
lcl|NC_002695.2_cds_NP_309891.1_1733,679,816,728,861,3084
lcl|NC_002695.2_cds_NP_309892.1_1734,331,299,353,391,1374
lcl|NC_002695.2_cds_NP_309893.1_1735,233,361,244,326,1164
lcl|NC_002695.2_cds_NP_309894.1_1736,195,197,195,220,807
lcl|NC_002695.2_cds_NP_309895.1_1737,257,237,241,258,993
lcl|NC_002695.2_cds_NP_309896.1_1738,147,234,244,266,891
lcl|NC_002695.2_cds_NP_309897.1_1739,185,286,244,251,966
lcl|NC_002695.2_cds_NP_309898.1_1740,363,389,450,442,1644
lcl|NC_002695.2_cds_NP_309899.1_1741,72,54,58,62,246
lcl|NC_002695.2_cds_NP_309900.2_1742,263,386,358,379,1386
lcl|NC_002695.2_cds_NP_309901.2_1743,335,333,348,403,1419
lcl|NC_002695.2_cds_NP_309902.3_1744,172,178,188,215,753
lcl|NC_002695.2_cds_NP_309903.1_1745,152,123,134,149,558
lcl|NC_002695.2_cds_NP_309904.1_1746,344,290,416,438,1488
lcl|NC_002695.2_cds_NP_309905.1_1747,266,259,372,384,1281
lcl|NC_002695.2_cds_NP_309906.1_1748,275,259,354,378,1266
lcl|NC_002695.2_cds_NP_309907.2_1749,236,232,240,270,978
lcl|NC_002695.2_cds_NP_309908.1_1750,206,131,142,190,669
lcl|NC_002695.2_cds_NP_309909.1_1751,55,64,47,59,225
lcl|NC_002695.2_cds_NP_309910.1_1752,76,106,82,96,360
lcl|NC_002695.2_cds_NP_309911.1_1753,53,47,52,70,222
lcl|NC_002695.2_cds_NP_309912.1_1754,88,68,74,85,315
lcl|NC_002695.2_cds_NP_309917.1_1755,160,257,230,235,882
lcl|NC_002695.2_cds_NP_309918.1_1756,163,240,220,220,843
lcl|NC_002695.2_cds_NP_309919.1_1757,241,234,272,306,1053
lcl|NC_002695.2_cds_NP_309920.1_1758,194,179,199,217,789
lcl|NC_002695.2_cds_NP_309921.1_1759,251,225,268,312,1056
lcl|NC_002695.2_cds_NP_309922.1_1760,530,511,574,653,2268
lcl|NC_002695.2_cds_NP_309923.1_1761,136,147,182,195,660
lcl|NC_002695.2_cds_NP_309924.1_1762,298,249,241,295,1083
lcl|NC_002695.2_cds_NP_309925.1_1763,227,231,191,257,906
lcl|NC_002695.2_cds_NP_309926.1_1764,282,265,213,239,999
lcl|NC_002695.2_cds_NP_309927.1_1765,297,332,358,411,1398
lcl|NC_002695.2_cds_NP_309928.1_1766,240,223,263,336,1062
lcl|NC_002695.2_cds_NP_309929.1_1767,369,376,360,437,1542
lcl|NC_002695.2_cds_NP_309930.1_1768,119,127,135,126,507
lcl|NC_002695.2_cds_NP_309931.2_1769,221,222,222,301,966
lcl|NC_002695.2_cds_NP_309932.2_1770,155,174,203,197,729
lcl|NC_002695.2_cds_NP_309933.3_1771,197,167,133,142,639
lcl|NC_002695.2_cds_NP_309936.2_1772,255,218,216,232,921
lcl|NC_002695.2_cds_NP_309937.1_1773,228,249,198,225,900
lcl|NC_002695.2_cds_NP_309938.2_1774,460,377,370,407,1614
lcl|NC_002695.2_cds_NP_309939.1_1775,266,316,218,232,1032
lcl|NC_002695.2_cds_NP_309940.1_1776,57,84,45,72,258
lcl|NC_002695.2_cds_NP_309941.1_1777,257,215,227,252,951
lcl|NC_002695.2_cds_NP_309942.1_1778,190,176,193,194,753
lcl|NC_002695.2_cds_NP_309943.1_1779,123,119,125,149,516
lcl|NC_002695.2_cds_NP_309945.2_1780,219,189,209,271,888
lcl|NC_002695.2_cds_NP_309946.1_1781,75,75,79,98,327
lcl|NC_002695.2_cds_NP_309948.1_1782,367,324,391,364,1446
lcl|NC_002695.2_cds_NP_309949.2_1783,283,301,343,384,1311
lcl|NC_002695.2_cds_NP_309950.1_1784,237,222,210,240,909
lcl|NC_002695.2_cds_NP_309951.1_1785,138,124,143,159,564
lcl|NC_002695.2_cds_NP_309952.2_1786,331,314,297,291,1233
lcl|NC_002695.2_cds_NP_309953.1_1787,216,258,220,290,984
lcl|NC_002695.2_cds_NP_309954.1_1788,322,341,324,387,1374
lcl|NC_002695.2_cds_NP_309955.1_1789,259,216,213,248,936
lcl|NC_002695.2_cds_NP_309956.1_1790,404,290,236,306,1236
lcl|NC_002695.2_cds_NP_309957.2_1791,67,53,41,55,216
lcl|NC_002695.2_cds_NP_309958.1_1792,78,42,33,36,189
lcl|NC_002695.2_cds_NP_309960.1_1793,250,186,182,192,810
lcl|NC_002695.2_cds_NP_309961.1_1794,751,554,648,648,2601
lcl|NC_002695.2_cds_NP_309962.1_1795,104,65,49,58,276
lcl|NC_002695.2_cds_YP_009502622.1_1796,70,38,29,34,171
lcl|NC_002695.2_cds_NP_309963.2_1797,68,60,47,47,222
lcl|NC_002695.2_cds_NP_309964.3_1798,161,209,130,112,612
lcl|NC_002695.2_cds_NP_309965.1_1799,52,27,40,37,156
lcl|NC_002695.2_cds_NP_309967.2_1800,36,35,26,38,135
lcl|NC_002695.2_cds_NP_309968.2_1801,162,88,76,94,420
lcl|NC_002695.2_cds_NP_309969.1_1802,89,65,47,54,255
lcl|NC_002695.2_cds_NP_309970.1_1803,111,92,102,118,423
lcl|NC_002695.2_cds_NP_309971.1_1804,233,168,174,214,789
lcl|NC_002695.2_cds_NP_309972.1_1805,192,151,171,233,747
lcl|NC_002695.2_cds_NP_309973.2_1806,216,150,179,217,762
lcl|NC_002695.2_cds_NP_309975.1_1807,121,95,86,121,423
lcl|NC_002695.2_cds_NP_309976.1_1808,79,49,33,52,213
lcl|NC_002695.2_cds_NP_309977.1_1809,77,76,47,64,264
lcl|NC_002695.2_cds_NP_309978.1_1810,50,40,30,42,162
lcl|NC_002695.2_cds_NP_309980.1_1811,375,357,180,240,1152
lcl|NC_002695.2_cds_NP_309981.1_1812,357,318,164,151,990
lcl|NC_002695.2_cds_NP_309982.1_1813,512,388,227,265,1392
lcl|NC_002695.2_cds_NP_309983.1_1814,143,158,140,159,600
lcl|NC_002695.2_cds_NP_309984.1_1815,91,59,65,76,291
lcl|NC_002695.2_cds_NP_309985.1_1816,164,134,98,159,555
lcl|NC_002695.2_cds_NP_309986.1_1817,116,97,84,135,432
lcl|NC_002695.2_cds_NP_309987.2_1818,129,119,169,102,519
lcl|NC_002695.2_cds_NP_309988.1_1819,439,384,483,548,1854
lcl|NC_002695.2_cds_NP_309989.1_1820,56,47,48,65,216
lcl|NC_002695.2_cds_NP_309990.1_1821,94,88,63,100,345
lcl|NC_002695.2_cds_NP_309991.1_1822,129,109,126,170,534
lcl|NC_002695.2_cds_NP_309992.1_1823,169,137,115,149,570
lcl|NC_002695.2_cds_NP_309993.2_1824,28,48,30,41,147
lcl|NC_002695.2_cds_YP_009502623.1_1825,115,92,124,137,468
lcl|NC_002695.2_cds_NP_309994.1_1826,76,52,54,46,228
lcl|NC_002695.2_cds_NP_309995.1_1827,75,83,93,115,366
lcl|NC_002695.2_cds_NP_309997.1_1828,153,101,137,173,564
lcl|NC_002695.2_cds_NP_309998.1_1829,349,352,412,549,1662
lcl|NC_002695.2_cds_NP_309999.1_1830,386,389,523,640,1938
lcl|NC_002695.2_cds_YP_009502624.1_1831,59,35,51,77,222
lcl|NC_002695.2_cds_NP_310001.1_1832,328,280,335,422,1365
lcl|NC_002695.2_cds_NP_310002.1_1833,275,253,290,406,1224
lcl|NC_002695.2_cds_NP_310003.1_1834,67,73,76,111,327
lcl|NC_002695.2_cds_NP_310004.1_1835,76,69,80,126,351
lcl|NC_002695.2_cds_NP_310005.1_1836,95,92,107,153,447
lcl|NC_002695.2_cds_NP_310006.1_1837,58,81,87,119,345
lcl|NC_002695.2_cds_NP_310007.1_1838,172,165,171,209,717
lcl|NC_002695.2_cds_NP_310008.1_1839,81,77,84,133,375
lcl|NC_002695.2_cds_NP_310009.2_1840,46,43,42,79,210
lcl|NC_002695.2_cds_NP_310010.1_1841,723,589,725,1044,3081
lcl|NC_002695.2_cds_NP_310011.1_1842,69,76,71,126,342
lcl|NC_002695.2_cds_NP_310012.1_1843,141,151,162,245,699
lcl|NC_002695.2_cds_NP_310013.1_1844,148,166,192,238,744
lcl|NC_002695.2_cds_NP_310014.2_1845,120,110,152,200,582
lcl|NC_002695.2_cds_NP_310016.1_1846,140,109,144,135,528
lcl|NC_002695.2_cds_NP_310017.1_1847,841,674,900,1083,3498
lcl|NC_002695.2_cds_NP_310018.1_1848,123,140,150,187,600
lcl|NC_002695.2_cds_NP_310019.2_1849,336,194,323,461,1314
lcl|NC_002695.2_cds_NP_310020.2_1850,79,57,46,88,270
lcl|NC_002695.2_cds_NP_310021.1_1851,155,177,103,141,576
lcl|NC_002695.2_cds_NP_310022.1_1852,194,183,103,150,630
lcl|NC_002695.2_cds_NP_310023.1_1853,202,203,93,144,642
lcl|NC_002695.2_cds_NP_310024.2_1854,116,107,110,102,435
lcl|NC_002695.2_cds_NP_310027.1_1855,821,814,942,948,3525
lcl|NC_002695.2_cds_YP_009502625.1_1856,53,67,58,89,267
lcl|NC_002695.2_cds_NP_310028.1_1857,131,93,89,110,423
lcl|NC_002695.2_cds_NP_310029.1_1858,254,238,240,258,990
lcl|NC_002695.2_cds_NP_310030.1_1859,623,638,625,754,2640
lcl|NC_002695.2_cds_NP_310031.1_1860,55,51,37,43,186
lcl|NC_002695.2_cds_NP_310032.2_1861,109,68,62,85,324
lcl|NC_002695.2_cds_NP_310033.1_1862,832,720,666,818,3036
lcl|NC_002695.2_cds_NP_310034.2_1863,670,450,606,734,2460
lcl|NC_002695.2_cds_NP_310035.1_1864,192,217,211,241,861
lcl|NC_002695.2_cds_NP_310036.2_1865,668,647,446,546,2307
lcl|NC_002695.2_cds_NP_310037.2_1866,130,203,131,142,606
lcl|NC_002695.2_cds_NP_310038.1_1867,202,300,168,227,897
lcl|NC_002695.2_cds_NP_310039.1_1868,397,458,411,492,1758
lcl|NC_002695.2_cds_NP_310040.2_1869,272,386,292,367,1317
lcl|NC_002695.2_cds_NP_310041.1_1870,147,147,152,160,606
lcl|NC_002695.2_cds_NP_310042.2_1871,955,853,973,1122,3903
lcl|NC_002695.2_cds_NP_310043.1_1872,144,139,66,77,426
lcl|NC_002695.2_cds_NP_310044.1_1873,118,107,39,75,339
lcl|NC_002695.2_cds_NP_310045.1_1874,149,127,62,94,432
lcl|NC_002695.2_cds_NP_310046.1_1875,118,118,65,77,378
lcl|NC_002695.2_cds_NP_310047.1_1876,197,197,205,202,801
lcl|NC_002695.2_cds_NP_310048.1_1877,367,337,323,413,1440
lcl|NC_002695.2_cds_NP_310049.1_1878,276,247,232,247,1002
lcl|NC_002695.2_cds_NP_310050.2_1879,120,157,121,133,531
lcl|NC_002695.2_cds_NP_310051.1_1880,45,51,34,44,174
lcl|NC_002695.2_cds_NP_310052.1_1881,43,39,48,38,168
lcl|NC_002695.2_cds_NP_310053.1_1882,429,373,377,462,1641
lcl|NC_002695.2_cds_NP_310054.2_1883,221,235,226,242,924
lcl|NC_002695.2_cds_NP_310055.1_1884,318,316,326,384,1344
lcl|NC_002695.2_cds_NP_310056.2_1885,381,408,400,431,1620
lcl|NC_002695.2_cds_NP_310058.2_1886,83,52,41,49,225
lcl|NC_002695.2_cds_NP_310060.1_1887,265,245,206,265,981
lcl|NC_002695.2_cds_NP_310061.1_1888,182,285,233,293,993
lcl|NC_002695.2_cds_NP_310062.1_1889,167,153,126,148,594
lcl|NC_002695.2_cds_NP_310063.1_1890,197,171,142,159,669
lcl|NC_002695.2_cds_NP_310065.2_1891,210,338,288,337,1173
lcl|NC_002695.2_cds_NP_310064.3_1892,131,142,134,130,537
lcl|NC_002695.2_cds_NP_310066.1_1893,514,474,483,533,2004
lcl|NC_002695.2_cds_NP_310067.2_1894,49,34,30,58,171
lcl|NC_002695.2_cds_YP_009502626.1_1895,51,39,39,48,177
lcl|NC_002695.2_cds_NP_310069.3_1896,119,123,95,101,438
lcl|NC_002695.2_cds_NP_310070.1_1897,334,346,349,378,1407
lcl|NC_002695.2_cds_NP_310071.1_1898,297,250,284,315,1146
lcl|NC_002695.2_cds_NP_310072.1_1899,220,238,249,307,1014
lcl|NC_002695.2_cds_NP_310073.1_1900,159,275,241,267,942
lcl|NC_002695.2_cds_NP_310074.1_1901,147,220,201,227,795
lcl|NC_002695.2_cds_NP_310075.1_1902,340,327,319,439,1425
lcl|NC_002695.2_cds_NP_310076.2_1903,32,66,39,37,174
lcl|NC_002695.2_cds_NP_310077.1_1904,64,46,59,65,234
lcl|NC_002695.2_cds_NP_310078.1_1905,77,139,108,126,450
lcl|NC_002695.2_cds_NP_310079.1_1906,119,126,120,154,519
lcl|NC_002695.2_cds_NP_310080.3_1907,243,250,222,323,1038
lcl|NC_002695.2_cds_NP_310081.2_1908,208,166,136,156,666
lcl|NC_002695.2_cds_NP_310082.1_1909,540,478,509,576,2103
lcl|NC_002695.2_cds_NP_310083.1_1910,290,237,254,281,1062
lcl|NC_002695.2_cds_NP_310084.2_1911,285,432,342,441,1500
lcl|NC_002695.2_cds_NP_310085.1_1912,154,172,130,162,618
lcl|NC_002695.2_cds_NP_310086.1_1913,67,82,34,30,213
lcl|NC_002695.2_cds_NP_310087.1_1914,517,424,535,633,2109
lcl|NC_002695.2_cds_NP_310088.2_1915,925,712,1148,1418,4203
lcl|NC_002695.2_cds_NP_310091.1_1916,76,52,53,47,228
lcl|NC_002695.2_cds_NP_310094.1_1917,217,212,228,237,894
lcl|NC_002695.2_cds_NP_310095.1_1918,126,196,164,195,681
lcl|NC_002695.2_cds_NP_310096.1_1919,160,147,172,217,696
lcl|NC_002695.2_cds_NP_310097.1_1920,387,321,407,430,1545
lcl|NC_002695.2_cds_NP_310098.1_1921,903,800,1028,1010,3741
lcl|NC_002695.2_cds_NP_310099.1_1922,281,423,334,351,1389
lcl|NC_002695.2_cds_NP_310100.1_1923,470,375,237,178,1260
lcl|NC_002695.2_cds_NP_310103.1_1924,314,300,233,254,1101
lcl|NC_002695.2_cds_NP_310104.4_1925,165,243,199,218,825
lcl|NC_002695.2_cds_NP_310105.1_1926,749,654,775,870,3048
lcl|NC_002695.2_cds_NP_310106.1_1927,209,189,220,267,885
lcl|NC_002695.2_cds_NP_310107.1_1928,156,172,141,185,654
lcl|NC_002695.2_cds_NP_310108.2_1929,76,60,70,79,285
lcl|NC_002695.2_cds_NP_310109.2_1930,240,234,230,307,1011
lcl|NC_002695.2_cds_NP_310110.2_1931,433,378,440,447,1698
lcl|NC_002695.2_cds_NP_310111.1_1932,52,24,34,28,138
lcl|NC_002695.2_cds_NP_310112.2_1933,62,54,50,50,216
lcl|NC_002695.2_cds_NP_310113.1_1934,126,90,96,120,432
lcl|NC_002695.2_cds_NP_310114.1_1935,209,214,246,258,927
lcl|NC_002695.2_cds_NP_310115.1_1936,223,228,258,278,987
lcl|NC_002695.2_cds_NP_310116.1_1937,178,239,225,255,897
lcl|NC_002695.2_cds_NP_310117.2_1938,164,274,250,293,981
lcl|NC_002695.2_cds_NP_310118.1_1939,440,326,399,386,1551
lcl|NC_002695.2_cds_NP_310119.1_1940,133,140,161,148,582
lcl|NC_002695.2_cds_NP_310122.1_1941,393,373,292,325,1383
lcl|NC_002695.2_cds_NP_310123.1_1942,339,293,344,344,1320
lcl|NC_002695.2_cds_NP_310124.1_1943,333,461,368,374,1536
lcl|NC_002695.2_cds_NP_310125.1_1944,326,324,373,378,1401
lcl|NC_002695.2_cds_NP_310126.2_1945,819,667,635,663,2784
lcl|NC_002695.2_cds_NP_310127.1_1946,679,602,547,545,2373
lcl|NC_002695.2_cds_NP_310128.2_1947,457,479,360,363,1659
lcl|NC_002695.2_cds_NP_310129.2_1948,357,349,219,233,1158
lcl|NC_002695.2_cds_NP_310130.2_1949,514,423,389,357,1683
lcl|NC_002695.2_cds_NP_310131.1_1950,233,230,148,151,762
lcl|NC_002695.2_cds_NP_310132.1_1951,65,59,36,38,198
lcl|NC_002695.2_cds_NP_310133.1_1952,586,553,538,603,2280
lcl|NC_002695.2_cds_NP_310134.1_1953,258,249,194,214,915
lcl|NC_002695.2_cds_NP_310135.1_1954,156,123,110,115,504
lcl|NC_002695.2_cds_NP_310136.1_1955,149,140,119,123,531
lcl|NC_002695.2_cds_NP_310137.2_1956,743,731,576,602,2652
lcl|NC_002695.2_cds_NP_310139.1_1957,204,180,179,148,711
lcl|NC_002695.2_cds_NP_310140.1_1958,137,163,119,145,564
lcl|NC_002695.2_cds_NP_310144.1_1959,1086,958,825,1163,4032
lcl|NC_002695.2_cds_NP_310145.3_1960,373,390,387,443,1593
lcl|NC_002695.2_cds_NP_310146.1_1961,233,234,211,276,954
lcl|NC_002695.2_cds_NP_310147.1_1962,363,359,396,418,1536
lcl|NC_002695.2_cds_NP_310148.1_1963,190,285,242,312,1029
lcl|NC_002695.2_cds_NP_310149.1_1964,164,295,252,282,993
lcl|NC_002695.2_cds_NP_310150.1_1965,282,234,234,273,1023
lcl|NC_002695.2_cds_NP_310151.1_1966,225,214,186,251,876
lcl|NC_002695.2_cds_NP_310152.1_1967,84,71,66,70,291
lcl|NC_002695.2_cds_NP_310153.1_1968,160,184,206,209,759
lcl|NC_002695.2_cds_NP_310154.2_1969,199,275,235,206,915
lcl|NC_002695.2_cds_NP_310155.1_1970,350,352,354,396,1452
lcl|NC_002695.2_cds_NP_310156.2_1971,304,422,311,382,1419
lcl|NC_002695.2_cds_NP_310157.1_1972,80,92,96,92,360
lcl|NC_002695.2_cds_NP_310158.1_1973,204,245,206,272,927
lcl|NC_002695.2_cds_NP_310159.2_1974,334,328,310,417,1389
lcl|NC_002695.2_cds_NP_310160.1_1975,192,220,224,246,882
lcl|NC_002695.2_cds_NP_310162.1_1976,233,350,279,329,1191
lcl|NC_002695.2_cds_NP_310163.1_1977,140,190,145,191,666
lcl|NC_002695.2_cds_NP_310164.2_1978,119,105,98,113,435
lcl|NC_002695.2_cds_NP_310165.2_1979,123,86,93,82,384
lcl|NC_002695.2_cds_NP_310166.1_1980,52,53,61,53,219
lcl|NC_002695.2_cds_NP_310167.1_1981,174,275,197,254,900
lcl|NC_002695.2_cds_NP_310168.1_1982,234,364,300,290,1188
lcl|NC_002695.2_cds_YP_009502627.1_1983,93,98,95,110,396
lcl|NC_002695.2_cds_NP_310170.2_1984,230,248,250,244,972
lcl|NC_002695.2_cds_YP_009502628.1_1985,24,36,14,22,96
lcl|NC_002695.2_cds_NP_310171.1_1986,243,252,171,225,891
lcl|NC_002695.2_cds_NP_310172.1_1987,109,103,81,100,393
lcl|NC_002695.2_cds_NP_310173.1_1988,137,123,120,139,519
lcl|NC_002695.2_cds_NP_310174.1_1989,518,507,480,541,2046
lcl|NC_002695.2_cds_NP_310175.1_1990,189,178,172,208,747
lcl|NC_002695.2_cds_NP_310176.1_1991,180,164,176,167,687
lcl|NC_002695.2_cds_NP_310177.1_1992,55,43,52,54,204
lcl|NC_002695.2_cds_NP_310178.1_1993,367,364,327,403,1461
lcl|NC_002695.2_cds_NP_310180.2_1994,89,90,73,63,315
lcl|NC_002695.2_cds_NP_310181.1_1995,202,204,92,144,642
lcl|NC_002695.2_cds_NP_310182.1_1996,197,181,102,150,630
lcl|NC_002695.2_cds_NP_310183.1_1997,155,177,103,141,576
lcl|NC_002695.2_cds_NP_310184.1_1998,82,55,47,86,270
lcl|NC_002695.2_cds_NP_310186.2_1999,217,121,200,272,810
lcl|NC_002695.2_cds_NP_310187.1_2000,120,139,152,189,600
lcl|NC_002695.2_cds_NP_310188.1_2001,834,652,914,1080,3480
lcl|NC_002695.2_cds_NP_310189.2_2002,119,107,148,205,579
lcl|NC_002695.2_cds_NP_310190.2_2003,139,159,204,242,744
lcl|NC_002695.2_cds_NP_310191.1_2004,147,148,156,248,699
lcl|NC_002695.2_cds_NP_310192.1_2005,70,70,72,118,330
lcl|NC_002695.2_cds_NP_310193.1_2006,605,492,613,903,2613
lcl|NC_002695.2_cds_NP_310194.1_2007,85,96,94,139,414
lcl|NC_002695.2_cds_NP_310195.1_2008,117,97,99,110,423
lcl|NC_002695.2_cds_NP_310196.1_2009,200,138,175,240,753
lcl|NC_002695.2_cds_NP_310197.1_2010,86,101,84,125,396
lcl|NC_002695.2_cds_NP_310198.1_2011,148,108,126,152,534
lcl|NC_002695.2_cds_NP_310199.1_2012,71,80,91,112,354
lcl|NC_002695.2_cds_NP_310200.1_2013,95,77,97,130,399
lcl|NC_002695.2_cds_NP_310201.1_2014,234,214,280,298,1026
lcl|NC_002695.2_cds_NP_310202.1_2015,74,60,102,97,333
lcl|NC_002695.2_cds_NP_310203.1_2016,276,242,380,422,1320
lcl|NC_002695.2_cds_NP_310204.1_2017,347,319,422,514,1602
lcl|NC_002695.2_cds_NP_310205.1_2018,58,36,48,65,207
lcl|NC_002695.2_cds_NP_310206.1_2019,472,412,478,564,1926
lcl|NC_002695.2_cds_NP_310207.1_2020,149,122,120,155,546
lcl|NC_002695.2_cds_NP_310209.1_2021,108,52,60,95,315
lcl|NC_002695.2_cds_NP_310211.2_2022,116,101,117,125,459
lcl|NC_002695.2_cds_NP_310210.2_2023,43,37,56,50,186
lcl|NC_002695.2_cds_YP_009502629.1_2024,27,49,28,43,147
lcl|NC_002695.2_cds_NP_310212.2_2025,169,137,115,149,570
lcl|NC_002695.2_cds_NP_310213.2_2026,130,110,125,169,534
lcl|NC_002695.2_cds_NP_310214.1_2027,95,87,62,101,345
lcl|NC_002695.2_cds_NP_310215.1_2028,50,44,43,70,207
lcl|NC_002695.2_cds_NP_310216.2_2029,439,384,473,555,1851
lcl|NC_002695.2_cds_YP_009502630.1_2030,31,46,33,58,168
lcl|NC_002695.2_cds_NP_310217.1_2031,118,93,84,137,432
lcl|NC_002695.2_cds_NP_310218.1_2032,155,174,109,150,588
lcl|NC_002695.2_cds_NP_310219.1_2033,54,45,45,54,198
lcl|NC_002695.2_cds_NP_310220.1_2034,166,138,92,159,555
lcl|NC_002695.2_cds_NP_310221.1_2035,75,72,74,85,306
lcl|NC_002695.2_cds_NP_310222.2_2036,248,235,276,291,1050
lcl|NC_002695.2_cds_NP_310223.1_2037,59,70,70,74,273
lcl|NC_002695.2_cds_NP_310224.1_2038,107,87,49,102,345
lcl|NC_002695.2_cds_NP_310225.1_2039,61,44,47,61,213
lcl|NC_002695.2_cds_NP_310226.1_2040,154,124,134,146,558
lcl|NC_002695.2_cds_NP_310228.1_2041,87,85,50,90,312
lcl|NC_002695.2_cds_NP_310229.1_2042,56,60,33,79,228
lcl|NC_002695.2_cds_NP_310230.1_2043,79,59,55,89,282
lcl|NC_002695.2_cds_NP_310231.2_2044,191,131,174,221,717
lcl|NC_002695.2_cds_NP_310232.2_2045,116,87,108,151,462
lcl|NC_002695.2_cds_NP_310233.1_2046,278,202,242,322,1044
lcl|NC_002695.2_cds_NP_310234.1_2047,106,94,101,125,426
lcl|NC_002695.2_cds_NP_310235.1_2048,72,56,52,63,243
lcl|NC_002695.2_cds_NP_310236.2_2049,92,101,77,69,339
lcl|NC_002695.2_cds_NP_310237.1_2050,65,53,56,60,234
lcl|NC_002695.2_cds_NP_310238.1_2051,210,165,121,143,639
lcl|NC_002695.2_cds_NP_310239.1_2052,70,62,39,39,210
lcl|NC_002695.2_cds_NP_310241.1_2053,53,64,33,39,189
lcl|NC_002695.2_cds_NP_310242.1_2054,62,47,38,42,189
lcl|NC_002695.2_cds_NP_310245.1_2055,69,76,61,49,255
lcl|NC_002695.2_cds_NP_310246.2_2056,219,189,209,271,888
lcl|NC_002695.2_cds_NP_310247.1_2057,75,75,79,98,327
lcl|NC_002695.2_cds_NP_310248.1_2058,212,182,235,241,870
lcl|NC_002695.2_cds_NP_310249.1_2059,103,81,106,91,381
lcl|NC_002695.2_cds_NP_310250.1_2060,69,75,99,105,348
lcl|NC_002695.2_cds_NP_310251.1_2061,345,294,425,475,1539
lcl|NC_002695.2_cds_NP_304958.1_2062,121,81,117,104,423
lcl|NC_002695.2_cds_NP_310257.1_2063,82,54,48,86,270
lcl|NC_002695.2_cds_NP_310258.1_2064,311,183,300,430,1224
lcl|NC_002695.2_cds_NP_310259.1_2065,120,139,152,189,600
lcl|NC_002695.2_cds_NP_304966.1_2066,54,55,45,62,216
lcl|NC_002695.2_cds_NP_304967.1_2067,502,419,567,642,2130
lcl|NC_002695.2_cds_NP_304968.1_2068,272,221,303,380,1176
lcl|NC_002695.2_cds_NP_310263.2_2069,114,116,154,198,582
lcl|NC_002695.2_cds_NP_310264.2_2070,148,166,193,237,744
lcl|NC_002695.2_cds_NP_310265.1_2071,146,151,157,245,699
lcl|NC_002695.2_cds_NP_310266.1_2072,70,79,71,122,342
lcl|NC_002695.2_cds_NP_310267.1_2073,776,608,769,1090,3243
lcl|NC_002695.2_cds_NP_310268.2_2074,46,42,43,79,210
lcl|NC_002695.2_cds_NP_310269.1_2075,81,78,83,133,375
lcl|NC_002695.2_cds_NP_310270.1_2076,169,158,176,214,717
lcl|NC_002695.2_cds_NP_310271.1_2077,59,79,88,119,345
lcl|NC_002695.2_cds_NP_310272.1_2078,97,89,107,154,447
lcl|NC_002695.2_cds_NP_310273.1_2079,76,67,82,126,351
lcl|NC_002695.2_cds_NP_310274.1_2080,69,74,74,110,327
lcl|NC_002695.2_cds_NP_310275.1_2081,593,531,622,834,2580
lcl|NC_002695.2_cds_YP_009502631.1_2082,59,35,51,77,222
lcl|NC_002695.2_cds_NP_310277.1_2083,386,389,523,640,1938
lcl|NC_002695.2_cds_NP_310278.1_2084,349,352,412,549,1662
lcl|NC_002695.2_cds_NP_310279.1_2085,153,101,137,173,564
lcl|NC_002695.2_cds_NP_310281.1_2086,75,83,93,115,366
lcl|NC_002695.2_cds_NP_310282.1_2087,76,52,54,46,228
lcl|NC_002695.2_cds_NP_310284.2_2088,115,92,124,137,468
lcl|NC_002695.2_cds_NP_310283.2_2089,41,35,56,54,186
lcl|NC_002695.2_cds_YP_009502632.1_2090,28,48,30,41,147
lcl|NC_002695.2_cds_NP_310285.1_2091,169,137,115,149,570
lcl|NC_002695.2_cds_NP_310286.1_2092,129,109,126,170,534
lcl|NC_002695.2_cds_NP_310287.1_2093,94,86,63,102,345
lcl|NC_002695.2_cds_NP_310288.1_2094,51,44,43,69,207
lcl|NC_002695.2_cds_NP_310289.1_2095,437,384,476,554,1851
lcl|NC_002695.2_cds_YP_009502633.1_2096,32,46,33,57,168
lcl|NC_002695.2_cds_NP_310292.1_2097,114,94,83,138,429
lcl|NC_002695.2_cds_NP_310294.1_2098,208,166,128,188,690
lcl|NC_002695.2_cds_NP_310295.1_2099,89,85,83,103,360
lcl|NC_002695.2_cds_NP_310296.1_2100,251,233,276,290,1050
lcl|NC_002695.2_cds_YP_009502634.1_2101,61,41,51,60,213
lcl|NC_002695.2_cds_NP_310298.1_2102,18,37,15,35,105
lcl|NC_002695.2_cds_NP_310299.1_2103,169,146,123,147,585
lcl|NC_002695.2_cds_NP_310300.1_2104,115,84,81,116,396
lcl|NC_002695.2_cds_NP_310301.1_2105,170,137,152,210,669
lcl|NC_002695.2_cds_NP_310302.1_2106,186,152,166,237,741
lcl|NC_002695.2_cds_NP_310303.2_2107,259,201,220,283,963
lcl|NC_002695.2_cds_NP_310304.1_2108,108,94,98,126,426
lcl|NC_002695.2_cds_NP_310305.1_2109,79,83,59,82,303
lcl|NC_002695.2_cds_NP_310306.2_2110,126,73,77,96,372
lcl|NC_002695.2_cds_NP_310307.2_2111,64,36,44,48,192
lcl|NC_002695.2_cds_NP_310308.1_2112,77,74,66,62,279
lcl|NC_002695.2_cds_NP_310309.2_2113,54,55,45,47,201
lcl|NC_002695.2_cds_NP_310310.2_2114,73,42,50,54,219
lcl|NC_002695.2_cds_YP_009502635.1_2115,33,46,51,35,165
lcl|NC_002695.2_cds_NP_310311.1_2116,65,53,33,38,189
lcl|NC_002695.2_cds_NP_310312.1_2117,55,53,40,44,192
lcl|NC_002695.2_cds_NP_310313.1_2118,749,505,594,624,2472
lcl|NC_002695.2_cds_NP_310314.2_2119,79,53,44,61,237
lcl|NC_002695.2_cds_NP_310315.1_2120,50,108,62,107,327
lcl|NC_002695.2_cds_NP_310316.1_2121,103,65,92,82,342
lcl|NC_002695.2_cds_NP_310317.1_2122,155,144,126,136,561
lcl|NC_002695.2_cds_NP_310318.3_2123,229,191,150,177,747
lcl|NC_002695.2_cds_NP_310319.2_2124,72,65,101,68,306
lcl|NC_002695.2_cds_NP_310320.1_2125,657,537,625,608,2427
lcl|NC_002695.2_cds_NP_310321.2_2126,643,529,601,624,2397
lcl|NC_002695.2_cds_NP_310322.1_2127,147,145,165,161,618
lcl|NC_002695.2_cds_NP_310323.1_2128,153,253,204,245,855
lcl|NC_002695.2_cds_NP_310324.2_2129,127,161,153,174,615
lcl|NC_002695.2_cds_NP_310325.2_2130,226,346,332,353,1257
lcl|NC_002695.2_cds_NP_310326.2_2131,176,158,164,198,696
lcl|NC_002695.2_cds_NP_310327.1_2132,283,298,297,343,1221
lcl|NC_002695.2_cds_NP_310328.1_2133,195,229,225,245,894
lcl|NC_002695.2_cds_NP_310329.1_2134,220,373,325,336,1254
lcl|NC_002695.2_cds_NP_310330.2_2135,109,41,91,68,309
lcl|NC_002695.2_cds_NP_310331.2_2136,197,198,194,233,822
lcl|NC_002695.2_cds_NP_310332.1_2137,53,106,70,101,330
lcl|NC_002695.2_cds_NP_310333.1_2138,88,125,60,93,366
lcl|NC_002695.2_cds_NP_310334.1_2139,205,316,240,274,1035
lcl|NC_002695.2_cds_NP_310335.1_2140,291,362,325,411,1389
lcl|NC_002695.2_cds_NP_310336.1_2141,371,355,359,448,1533
lcl|NC_002695.2_cds_NP_310337.1_2142,257,208,238,242,945
lcl|NC_002695.2_cds_NP_310338.1_2143,257,391,345,390,1383
lcl|NC_002695.2_cds_NP_310339.1_2144,182,174,181,186,723
lcl|NC_002695.2_cds_NP_310340.1_2145,65,112,69,90,336
lcl|NC_002695.2_cds_NP_310341.2_2146,185,180,181,174,720
lcl|NC_002695.2_cds_NP_310342.2_2147,298,348,323,333,1302
lcl|NC_002695.2_cds_NP_310343.1_2148,242,218,240,230,930
lcl|NC_002695.2_cds_NP_310344.1_2149,361,282,354,407,1404
lcl|NC_002695.2_cds_NP_310345.1_2150,433,368,395,451,1647
lcl|NC_002695.2_cds_NP_310346.1_2151,295,284,296,301,1176
lcl|NC_002695.2_cds_NP_310347.1_2152,452,317,348,392,1509
lcl|NC_002695.2_cds_NP_305057.1_2153,183,161,161,209,714
lcl|NC_002695.2_cds_NP_310353.1_2154,152,139,146,154,591
lcl|NC_002695.2_cds_NP_310354.1_2155,207,198,172,191,768
lcl|NC_002695.2_cds_NP_310355.1_2156,230,237,251,311,1029
lcl|NC_002695.2_cds_NP_310356.1_2157,323,425,419,426,1593
lcl|NC_002695.2_cds_NP_310357.1_2158,269,300,283,321,1173
lcl|NC_002695.2_cds_NP_310358.1_2159,231,237,270,264,1002
lcl|NC_002695.2_cds_NP_310359.2_2160,238,249,255,299,1041
lcl|NC_002695.2_cds_NP_310360.1_2161,35,38,27,26,126
lcl|NC_002695.2_cds_NP_310361.1_2162,57,58,53,48,216
lcl|NC_002695.2_cds_NP_310362.2_2163,87,137,113,104,441
lcl|NC_002695.2_cds_NP_310363.1_2164,94,190,139,159,582
lcl|NC_002695.2_cds_NP_310364.1_2165,122,140,150,167,579
lcl|NC_002695.2_cds_NP_310365.1_2166,593,439,641,646,2319
lcl|NC_002695.2_cds_NP_310366.1_2167,205,294,274,286,1059
lcl|NC_002695.2_cds_NP_310367.1_2168,162,131,154,174,621
lcl|NC_002695.2_cds_NP_310368.1_2169,150,182,175,189,696
lcl|NC_002695.2_cds_NP_310369.1_2170,172,153,156,155,636
lcl|NC_002695.2_cds_NP_310370.1_2171,302,425,369,407,1503
lcl|NC_002695.2_cds_NP_310371.1_2172,161,141,144,160,606
lcl|NC_002695.2_cds_NP_310372.2_2173,206,205,207,243,861
lcl|NC_002695.2_cds_NP_310373.1_2174,320,294,308,353,1275
lcl|NC_002695.2_cds_NP_310374.1_2175,157,163,166,171,657
lcl|NC_002695.2_cds_NP_310375.4_2176,89,86,76,73,324
lcl|NC_002695.2_cds_NP_310376.1_2177,234,266,290,320,1110
lcl|NC_002695.2_cds_NP_310377.1_2178,109,122,99,138,468
lcl|NC_002695.2_cds_NP_310378.2_2179,131,95,104,105,435
lcl|NC_002695.2_cds_NP_310379.1_2180,37,83,58,59,237
lcl|NC_002695.2_cds_NP_310380.2_2181,225,202,220,211,858
lcl|NC_002695.2_cds_NP_310381.1_2182,406,542,535,530,2013
lcl|NC_002695.2_cds_NP_310382.1_2183,137,108,132,145,522
lcl|NC_002695.2_cds_NP_310385.2_2184,60,55,55,70,240
lcl|NC_002695.2_cds_NP_310384.2_2185,156,132,161,151,600
lcl|NC_002695.2_cds_NP_310386.1_2186,262,256,278,302,1098
lcl|NC_002695.2_cds_NP_310387.1_2187,110,88,95,115,408
lcl|NC_002695.2_cds_NP_310388.1_2188,151,144,187,166,648
lcl|NC_002695.2_cds_NP_310389.1_2189,976,1018,1284,1339,4617
lcl|NC_002695.2_cds_NP_310390.1_2190,90,75,88,95,348
lcl|NC_002695.2_cds_NP_310391.1_2191,259,168,211,178,816
lcl|NC_002695.2_cds_NP_310392.1_2192,152,143,150,137,582
lcl|NC_002695.2_cds_NP_310393.1_2193,222,321,277,350,1170
lcl|NC_002695.2_cds_YP_009502636.1_2194,18,26,23,23,90
lcl|NC_002695.2_cds_NP_310394.1_2195,252,230,255,289,1026
lcl|NC_002695.2_cds_NP_310395.1_2196,203,227,212,291,933
lcl|NC_002695.2_cds_NP_310396.1_2197,219,348,317,328,1212
lcl|NC_002695.2_cds_NP_310397.1_2198,286,308,260,295,1149
lcl|NC_002695.2_cds_NP_310398.1_2199,186,149,136,171,642
lcl|NC_002695.2_cds_NP_310399.1_2200,253,387,336,398,1374
lcl|NC_002695.2_cds_NP_310400.1_2201,323,285,260,389,1257
lcl|NC_002695.2_cds_NP_310401.1_2202,93,75,68,70,306
lcl|NC_002695.2_cds_NP_310402.1_2203,438,411,364,392,1605
lcl|NC_002695.2_cds_NP_310403.2_2204,185,174,177,229,765
lcl|NC_002695.2_cds_NP_310404.1_2205,158,236,170,222,786
lcl|NC_002695.2_cds_NP_310405.2_2206,166,167,164,172,669
lcl|NC_002695.2_cds_NP_310406.2_2207,156,150,149,184,639
lcl|NC_002695.2_cds_NP_310407.1_2208,567,528,460,548,2103
lcl|NC_002695.2_cds_NP_310408.1_2209,164,155,145,163,627
lcl|NC_002695.2_cds_NP_310409.1_2210,70,42,37,61,210
lcl|NC_002695.2_cds_NP_310410.1_2211,386,320,352,355,1413
lcl|NC_002695.2_cds_NP_310411.1_2212,64,53,61,59,237
lcl|NC_002695.2_cds_NP_310412.1_2213,257,219,256,273,1005
lcl|NC_002695.2_cds_NP_310413.1_2214,109,103,95,110,417
lcl|NC_002695.2_cds_NP_310414.1_2215,266,285,315,355,1221
lcl|NC_002695.2_cds_NP_310415.1_2216,333,262,316,361,1272
lcl|NC_002695.2_cds_NP_310416.1_2217,189,184,166,208,747
lcl|NC_002695.2_cds_NP_310417.2_2218,385,332,365,406,1488
lcl|NC_002695.2_cds_NP_310418.1_2219,86,85,88,110,369
lcl|NC_002695.2_cds_NP_310419.2_2220,49,57,50,33,189
lcl|NC_002695.2_cds_NP_310420.1_2221,101,98,89,123,411
lcl|NC_002695.2_cds_NP_310421.1_2222,690,728,768,871,3057
lcl|NC_002695.2_cds_NP_310422.1_2223,190,316,274,333,1113
lcl|NC_002695.2_cds_NP_310423.2_2224,102,92,82,81,357
lcl|NC_002695.2_cds_NP_310424.1_2225,262,410,280,263,1215
lcl|NC_002695.2_cds_NP_310425.2_2226,278,411,280,297,1266
lcl|NC_002695.2_cds_NP_310426.1_2227,244,211,186,226,867
lcl|NC_002695.2_cds_NP_310427.1_2228,195,180,191,193,759
lcl|NC_002695.2_cds_NP_310428.1_2229,424,416,349,407,1596
lcl|NC_002695.2_cds_NP_310429.2_2230,303,259,281,309,1152
lcl|NC_002695.2_cds_NP_310430.1_2231,264,265,180,203,912
lcl|NC_002695.2_cds_NP_310431.1_2232,200,171,196,198,765
lcl|NC_002695.2_cds_NP_310432.1_2233,231,209,234,265,939
lcl|NC_002695.2_cds_NP_310433.1_2234,299,291,329,371,1290
lcl|NC_002695.2_cds_NP_310434.1_2235,76,76,71,71,294
lcl|NC_002695.2_cds_NP_310435.2_2236,406,422,392,427,1647
lcl|NC_002695.2_cds_NP_310436.1_2237,538,541,602,698,2379
lcl|NC_002695.2_cds_NP_310437.1_2238,201,210,215,208,834
lcl|NC_002695.2_cds_NP_310438.1_2239,261,234,284,268,1047
lcl|NC_002695.2_cds_NP_310439.1_2240,55,40,51,46,192
lcl|NC_002695.2_cds_NP_310440.1_2241,326,364,340,407,1437
lcl|NC_002695.2_cds_NP_310441.1_2242,196,216,153,149,714
lcl|NC_002695.2_cds_NP_310442.1_2243,112,123,111,119,465
lcl|NC_002695.2_cds_NP_310443.1_2244,177,161,192,220,750
lcl|NC_002695.2_cds_NP_310444.1_2245,146,135,115,156,552
lcl|NC_002695.2_cds_NP_310445.1_2246,157,283,240,301,981
lcl|NC_002695.2_cds_NP_310446.1_2247,87,63,67,83,300
lcl|NC_002695.2_cds_NP_310447.1_2248,553,545,579,711,2388
lcl|NC_002695.2_cds_NP_310448.1_2249,223,229,267,265,984
lcl|NC_002695.2_cds_NP_310449.1_2250,8,21,10,6,45
lcl|NC_002695.2_cds_NP_310450.1_2251,97,87,87,86,357
lcl|NC_002695.2_cds_NP_310451.3_2252,61,38,53,46,198
lcl|NC_002695.2_cds_NP_310452.1_2253,169,110,117,147,543
lcl|NC_002695.2_cds_NP_310453.1_2254,515,450,457,507,1929
lcl|NC_002695.2_cds_NP_310454.1_2255,598,554,409,338,1899
lcl|NC_002695.2_cds_NP_310455.1_2256,188,197,180,194,759
lcl|NC_002695.2_cds_NP_310456.3_2257,233,194,242,261,930
lcl|NC_002695.2_cds_NP_310457.1_2258,93,70,57,71,291
lcl|NC_002695.2_cds_NP_310458.1_2259,194,220,226,221,861
lcl|NC_002695.2_cds_NP_310459.1_2260,121,181,103,132,537
lcl|NC_002695.2_cds_NP_310460.1_2261,161,161,174,173,669
lcl|NC_002695.2_cds_NP_310461.2_2262,120,173,153,145,591
lcl|NC_002695.2_cds_NP_310462.1_2263,274,384,347,387,1392
lcl|NC_002695.2_cds_NP_310463.3_2264,249,250,120,137,756
lcl|NC_002695.2_cds_NP_310464.1_2265,66,60,64,74,264
lcl|NC_002695.2_cds_NP_310465.1_2266,576,521,605,560,2262
lcl|NC_002695.2_cds_NP_310466.1_2267,170,208,162,219,759
lcl|NC_002695.2_cds_NP_310467.1_2268,360,357,281,355,1353
lcl|NC_002695.2_cds_NP_310468.2_2269,244,248,154,194,840
lcl|NC_002695.2_cds_NP_310469.1_2270,104,75,69,103,351
lcl|NC_002695.2_cds_NP_310470.1_2271,296,396,323,344,1359
lcl|NC_002695.2_cds_NP_310471.1_2272,92,88,62,79,321
lcl|NC_002695.2_cds_NP_310472.1_2273,94,78,75,92,339
lcl|NC_002695.2_cds_NP_310473.1_2274,238,183,193,214,828
lcl|NC_002695.2_cds_NP_310474.1_2275,210,220,217,241,888
lcl|NC_002695.2_cds_NP_310475.2_2276,136,145,129,166,576
lcl|NC_002695.2_cds_NP_310476.1_2277,158,82,130,116,486
lcl|NC_002695.2_cds_NP_310477.1_2278,208,238,234,289,969
lcl|NC_002695.2_cds_NP_310478.1_2279,293,311,340,400,1344
lcl|NC_002695.2_cds_NP_310479.1_2280,294,323,386,476,1479
lcl|NC_002695.2_cds_NP_310480.1_2281,228,231,273,303,1035
lcl|NC_002695.2_cds_NP_310481.1_2282,268,293,295,365,1221
lcl|NC_002695.2_cds_NP_310482.1_2283,202,172,212,221,807
lcl|NC_002695.2_cds_NP_310483.2_2284,151,221,196,143,711
lcl|NC_002695.2_cds_NP_310484.2_2285,201,152,145,180,678
lcl|NC_002695.2_cds_NP_310485.1_2286,128,213,177,190,708
lcl|NC_002695.2_cds_NP_310486.1_2287,106,132,151,160,549
lcl|NC_002695.2_cds_NP_310487.2_2288,265,255,325,322,1167
lcl|NC_002695.2_cds_NP_310488.2_2289,261,412,402,461,1536
lcl|NC_002695.2_cds_NP_310489.1_2290,141,181,156,176,654
lcl|NC_002695.2_cds_NP_310490.2_2291,340,267,345,356,1308
lcl|NC_002695.2_cds_NP_310491.2_2292,98,192,142,189,621
lcl|NC_002695.2_cds_NP_310492.1_2293,96,91,100,121,408
lcl|NC_002695.2_cds_NP_310493.1_2294,71,63,63,76,273
lcl|NC_002695.2_cds_NP_310494.1_2295,316,309,339,380,1344
lcl|NC_002695.2_cds_NP_310495.1_2296,313,301,190,237,1041
lcl|NC_002695.2_cds_NP_310496.1_2297,465,414,505,578,1962
lcl|NC_002695.2_cds_NP_310497.1_2298,239,227,255,323,1044
lcl|NC_002695.2_cds_NP_310498.1_2299,126,115,146,165,552
lcl|NC_002695.2_cds_NP_310499.1_2300,440,449,448,520,1857
lcl|NC_002695.2_cds_NP_310500.3_2301,206,164,160,181,711
lcl|NC_002695.2_cds_NP_310501.1_2302,258,242,266,251,1017
lcl|NC_002695.2_cds_NP_310502.2_2303,150,150,157,185,642
lcl|NC_002695.2_cds_NP_310504.1_2304,80,73,80,94,327
lcl|NC_002695.2_cds_NP_310505.1_2305,217,192,208,271,888
lcl|NC_002695.2_cds_NP_310506.1_2306,240,197,143,179,759
lcl|NC_002695.2_cds_NP_310507.1_2307,264,247,207,263,981
lcl|NC_002695.2_cds_NP_310508.1_2308,269,241,182,241,933
lcl|NC_002695.2_cds_NP_310509.1_2309,231,224,167,215,837
lcl|NC_002695.2_cds_NP_310510.1_2310,292,266,209,277,1044
lcl|NC_002695.2_cds_NP_310511.1_2311,302,399,312,367,1380
lcl|NC_002695.2_cds_NP_310512.1_2312,270,268,240,299,1077
lcl|NC_002695.2_cds_NP_310513.2_2313,88,61,55,69,273
lcl|NC_002695.2_cds_NP_310514.1_2314,108,107,95,104,414
lcl|NC_002695.2_cds_NP_310515.1_2315,259,239,259,239,996
lcl|NC_002695.2_cds_NP_310516.2_2316,232,212,221,220,885
lcl|NC_002695.2_cds_NP_310517.1_2317,221,197,195,242,855
lcl|NC_002695.2_cds_NP_310518.1_2318,178,181,194,194,747
lcl|NC_002695.2_cds_NP_310519.1_2319,513,456,478,488,1935
lcl|NC_002695.2_cds_NP_310520.1_2320,348,302,311,323,1284
lcl|NC_002695.2_cds_NP_310521.3_2321,371,450,267,256,1344
lcl|NC_002695.2_cds_NP_310522.2_2322,398,409,338,346,1491
lcl|NC_002695.2_cds_NP_310523.1_2323,127,119,130,128,504
lcl|NC_002695.2_cds_NP_310525.1_2324,75,128,111,133,447
lcl|NC_002695.2_cds_NP_310526.2_2325,218,191,194,216,819
lcl|NC_002695.2_cds_NP_310527.1_2326,216,341,309,316,1182
lcl|NC_002695.2_cds_NP_310528.2_2327,100,66,93,89,348
lcl|NC_002695.2_cds_NP_310529.1_2328,63,59,61,72,255
lcl|NC_002695.2_cds_NP_310531.1_2329,48,86,39,76,249
lcl|NC_002695.2_cds_NP_310532.1_2330,54,44,34,51,183
lcl|NC_002695.2_cds_NP_310533.1_2331,98,86,89,87,360
lcl|NC_002695.2_cds_NP_310534.1_2332,145,207,128,159,639
lcl|NC_002695.2_cds_NP_310535.2_2333,201,238,221,264,924
lcl|NC_002695.2_cds_NP_310536.1_2334,237,262,282,305,1086
lcl|NC_002695.2_cds_NP_310537.2_2335,350,447,425,389,1611
lcl|NC_002695.2_cds_NP_310538.1_2336,284,262,284,295,1125
lcl|NC_002695.2_cds_NP_310539.1_2337,250,230,223,263,966
lcl|NC_002695.2_cds_NP_310540.2_2338,252,256,286,322,1116
lcl|NC_002695.2_cds_NP_310541.2_2339,425,429,410,488,1752
lcl|NC_002695.2_cds_NP_310542.1_2340,137,129,139,177,582
lcl|NC_002695.2_cds_NP_310543.1_2341,165,148,172,211,696
lcl|NC_002695.2_cds_NP_310544.1_2342,429,422,517,543,1911
lcl|NC_002695.2_cds_NP_310545.3_2343,91,76,85,96,348
lcl|NC_002695.2_cds_NP_310546.2_2344,98,66,56,80,300
lcl|NC_002695.2_cds_NP_310547.1_2345,48,31,44,57,180
lcl|NC_002695.2_cds_NP_310548.1_2346,339,332,347,344,1362
lcl|NC_002695.2_cds_NP_310549.1_2347,121,144,160,154,579
lcl|NC_002695.2_cds_NP_310550.1_2348,309,319,343,394,1365
lcl|NC_002695.2_cds_NP_310551.2_2349,381,415,411,392,1599
lcl|NC_002695.2_cds_NP_310552.1_2350,315,400,385,457,1557
lcl|NC_002695.2_cds_NP_310554.1_2351,272,216,228,256,972
lcl|NC_002695.2_cds_NP_310555.1_2352,164,225,200,212,801
lcl|NC_002695.2_cds_NP_310556.4_2353,179,223,221,229,852
lcl|NC_002695.2_cds_NP_310557.1_2354,112,139,108,100,459
lcl|NC_002695.2_cds_NP_310558.2_2355,111,163,131,162,567
lcl|NC_002695.2_cds_NP_310559.1_2356,199,198,196,217,810
lcl|NC_002695.2_cds_NP_310560.1_2357,58,54,43,55,210
lcl|NC_002695.2_cds_NP_310562.1_2358,84,81,50,73,288
lcl|NC_002695.2_cds_YP_009502637.1_2359,70,66,44,60,240
lcl|NC_002695.2_cds_NP_310564.1_2360,202,197,177,216,792
lcl|NC_002695.2_cds_NP_310565.2_2361,247,413,366,348,1374
lcl|NC_002695.2_cds_NP_310566.1_2362,190,222,213,257,882
lcl|NC_002695.2_cds_NP_310567.1_2363,553,473,464,559,2049
lcl|NC_002695.2_cds_NP_310568.1_2364,195,132,181,191,699
lcl|NC_002695.2_cds_NP_310569.3_2365,138,148,114,152,552
lcl|NC_002695.2_cds_NP_310570.1_2366,266,371,305,342,1284
lcl|NC_002695.2_cds_NP_310571.2_2367,628,607,650,749,2634
lcl|NC_002695.2_cds_NP_310572.3_2368,344,375,401,401,1521
lcl|NC_002695.2_cds_NP_310573.2_2369,60,61,61,55,237
lcl|NC_002695.2_cds_NP_310574.1_2370,59,92,52,73,276
lcl|NC_002695.2_cds_NP_310575.2_2371,161,180,135,181,657
lcl|NC_002695.2_cds_NP_310576.1_2372,96,84,76,86,342
lcl|NC_002695.2_cds_NP_310577.1_2373,160,250,209,254,873
lcl|NC_002695.2_cds_NP_310578.1_2374,109,78,98,90,375
lcl|NC_002695.2_cds_NP_310579.1_2375,63,57,50,61,231
lcl|NC_002695.2_cds_NP_310580.1_2376,138,177,174,168,657
lcl|NC_002695.2_cds_NP_310581.1_2377,162,157,171,173,663
lcl|NC_002695.2_cds_NP_310582.1_2378,510,523,499,529,2061
lcl|NC_002695.2_cds_NP_310583.1_2379,171,143,155,191,660
lcl|NC_002695.2_cds_NP_310584.2_2380,96,84,72,105,357
lcl|NC_002695.2_cds_NP_310585.1_2381,88,59,66,78,291
lcl|NC_002695.2_cds_NP_310586.1_2382,248,294,290,347,1179
lcl|NC_002695.2_cds_NP_310587.1_2383,139,141,159,203,642
lcl|NC_002695.2_cds_NP_310588.1_2384,405,437,449,521,1812
lcl|NC_002695.2_cds_NP_310589.1_2385,380,333,357,406,1476
lcl|NC_002695.2_cds_NP_310590.1_2386,223,218,208,221,870
lcl|NC_002695.2_cds_NP_310591.1_2387,357,328,358,400,1443
lcl|NC_002695.2_cds_NP_310592.1_2388,242,230,224,276,972
lcl|NC_002695.2_cds_NP_310593.2_2389,329,295,333,366,1323
lcl|NC_002695.2_cds_NP_310594.4_2390,274,240,225,248,987
lcl|NC_002695.2_cds_NP_310595.1_2391,179,207,177,193,756
lcl|NC_002695.2_cds_NP_310596.1_2392,129,256,158,243,786
lcl|NC_002695.2_cds_NP_310597.1_2393,217,262,237,295,1011
lcl|NC_002695.2_cds_NP_310598.1_2394,156,129,153,174,612
lcl|NC_002695.2_cds_NP_310599.2_2395,168,172,126,137,603
lcl|NC_002695.2_cds_NP_310600.1_2396,120,110,136,156,522
lcl|NC_002695.2_cds_NP_310601.1_2397,201,155,174,211,741
lcl|NC_002695.2_cds_NP_310602.2_2398,126,120,114,150,510
lcl|NC_002695.2_cds_NP_310603.1_2399,414,400,457,502,1773
lcl|NC_002695.2_cds_NP_310604.2_2400,133,136,143,155,567
lcl|NC_002695.2_cds_NP_310605.1_2401,194,210,218,197,819
lcl|NC_002695.2_cds_NP_310606.2_2402,67,131,83,115,396
lcl|NC_002695.2_cds_NP_310607.1_2403,177,190,188,189,744
lcl|NC_002695.2_cds_NP_310608.1_2404,223,247,233,269,972
lcl|NC_002695.2_cds_NP_310609.2_2405,651,525,569,685,2430
lcl|NC_002695.2_cds_NP_310610.1_2406,318,258,245,280,1101
lcl|NC_002695.2_cds_NP_310611.2_2407,181,175,179,212,747
lcl|NC_002695.2_cds_NP_310612.2_2408,140,142,135,150,567
lcl|NC_002695.2_cds_NP_310613.1_2409,447,367,435,485,1734
lcl|NC_002695.2_cds_NP_310614.1_2410,169,138,91,91,489
lcl|NC_002695.2_cds_NP_310615.2_2411,81,104,88,123,396
lcl|NC_002695.2_cds_NP_310616.1_2412,436,509,511,623,2079
lcl|NC_002695.2_cds_NP_310617.1_2413,253,266,288,342,1149
lcl|NC_002695.2_cds_NP_310618.1_2414,161,139,155,190,645
lcl|NC_002695.2_cds_NP_310619.1_2415,106,90,75,119,390
lcl|NC_002695.2_cds_NP_310620.1_2416,248,235,248,319,1050
lcl|NC_002695.2_cds_NP_310621.1_2417,186,210,225,240,861
lcl|NC_002695.2_cds_NP_310622.1_2418,404,338,387,473,1602
lcl|NC_002695.2_cds_NP_310623.1_2419,424,367,429,442,1662
lcl|NC_002695.2_cds_NP_310624.1_2420,125,119,109,151,504
lcl|NC_002695.2_cds_NP_310625.1_2421,500,422,492,551,1965
lcl|NC_002695.2_cds_NP_310626.1_2422,240,195,238,254,927
lcl|NC_002695.2_cds_NP_310627.1_2423,202,231,207,248,888
lcl|NC_002695.2_cds_NP_310628.1_2424,153,141,139,146,579
lcl|NC_002695.2_cds_NP_310629.2_2425,97,90,89,75,351
lcl|NC_002695.2_cds_NP_310630.1_2426,115,120,88,106,429
lcl|NC_002695.2_cds_NP_310631.1_2427,368,357,340,360,1425
lcl|NC_002695.2_cds_NP_310632.1_2428,211,182,186,222,801
lcl|NC_002695.2_cds_NP_310635.1_2429,366,360,364,425,1515
lcl|NC_002695.2_cds_NP_310636.1_2430,267,213,225,285,990
lcl|NC_002695.2_cds_NP_310637.1_2431,142,120,125,117,504
lcl|NC_002695.2_cds_YP_009502638.1_2432,66,63,66,57,252
lcl|NC_002695.2_cds_NP_310639.1_2433,65,97,84,78,324
lcl|NC_002695.2_cds_NP_310640.1_2434,157,127,116,98,498
lcl|NC_002695.2_cds_NP_310641.1_2435,68,61,45,66,240
lcl|NC_002695.2_cds_NP_310642.1_2436,221,371,260,360,1212
lcl|NC_002695.2_cds_NP_310643.1_2437,164,148,142,212,666
lcl|NC_002695.2_cds_NP_310644.1_2438,272,283,181,266,1002
lcl|NC_002695.2_cds_NP_310645.1_2439,105,120,49,74,348
lcl|NC_002695.2_cds_NP_310646.1_2440,187,196,120,148,651
lcl|NC_002695.2_cds_NP_310647.1_2441,115,112,62,116,405
lcl|NC_002695.2_cds_NP_305354.1_2442,25,37,32,44,138
lcl|NC_002695.2_cds_NP_310649.1_2443,69,49,45,41,204
lcl|NC_002695.2_cds_NP_310650.1_2444,106,80,88,77,351
lcl|NC_002695.2_cds_NP_310651.1_2445,85,75,56,63,279
lcl|NC_002695.2_cds_NP_310652.1_2446,68,64,53,58,243
lcl|NC_002695.2_cds_YP_009502639.1_2447,32,42,18,22,114
lcl|NC_002695.2_cds_NP_310653.1_2448,146,88,103,80,417
lcl|NC_002695.2_cds_NP_310654.1_2449,56,42,60,46,204
lcl|NC_002695.2_cds_NP_310655.1_2450,70,51,78,68,267
lcl|NC_002695.2_cds_NP_310656.1_2451,74,63,91,72,300
lcl|NC_002695.2_cds_NP_310657.1_2452,146,142,185,145,618
lcl|NC_002695.2_cds_NP_310658.1_2453,65,47,74,45,231
lcl|NC_002695.2_cds_NP_310659.1_2454,89,84,106,87,366
lcl|NC_002695.2_cds_NP_310660.2_2455,727,474,830,792,2823
lcl|NC_002695.2_cds_NP_310661.1_2456,230,204,252,274,960
lcl|NC_002695.2_cds_NP_310662.1_2457,95,61,89,70,315
lcl|NC_002695.2_cds_NP_310663.1_2458,157,160,162,211,690
lcl|NC_002695.2_cds_NP_310664.2_2459,80,73,80,94,327
lcl|NC_002695.2_cds_YP_009502640.1_2460,112,98,80,127,417
lcl|NC_002695.2_cds_NP_310665.2_2461,201,177,71,124,573
lcl|NC_002695.2_cds_NP_310666.3_2462,115,131,109,134,489
lcl|NC_002695.2_cds_NP_310670.1_2463,107,81,74,104,366
lcl|NC_002695.2_cds_NP_310671.1_2464,121,116,121,155,513
lcl|NC_002695.2_cds_NP_310672.1_2465,287,268,288,342,1185
lcl|NC_002695.2_cds_NP_310673.1_2466,79,70,85,90,324
lcl|NC_002695.2_cds_NP_305380.1_2467,331,223,236,242,1032
lcl|NC_002695.2_cds_NP_305381.1_2468,51,51,38,55,195
lcl|NC_002695.2_cds_NP_305382.1_2469,87,81,37,77,282
lcl|NC_002695.2_cds_NP_310677.1_2470,94,168,131,156,549
lcl|NC_002695.2_cds_NP_310678.2_2471,458,429,447,499,1833
lcl|NC_002695.2_cds_NP_310679.1_2472,178,152,150,177,657
lcl|NC_002695.2_cds_NP_310680.1_2473,69,47,51,58,225
lcl|NC_002695.2_cds_NP_310681.1_2474,199,183,159,182,723
lcl|NC_002695.2_cds_NP_310682.1_2475,181,165,181,226,753
lcl|NC_002695.2_cds_NP_310683.1_2476,134,186,172,177,669
lcl|NC_002695.2_cds_NP_310686.2_2477,242,196,174,246,858
lcl|NC_002695.2_cds_NP_310687.2_2478,150,141,139,122,552
lcl|NC_002695.2_cds_NP_310688.1_2479,187,148,176,209,720
lcl|NC_002695.2_cds_NP_310689.1_2480,489,414,440,415,1758
lcl|NC_002695.2_cds_NP_310690.1_2481,400,265,400,333,1398
lcl|NC_002695.2_cds_NP_310691.1_2482,116,92,98,105,411
lcl|NC_002695.2_cds_NP_310692.1_2483,97,80,88,101,366
lcl|NC_002695.2_cds_NP_310693.1_2484,382,370,335,401,1488
lcl|NC_002695.2_cds_NP_310694.3_2485,98,82,102,132,414
lcl|NC_002695.2_cds_NP_310695.1_2486,219,325,308,354,1206
lcl|NC_002695.2_cds_NP_310696.1_2487,64,57,53,60,234
lcl|NC_002695.2_cds_NP_310697.1_2488,163,155,164,187,669
lcl|NC_002695.2_cds_NP_305404.1_2489,125,130,111,114,480
lcl|NC_002695.2_cds_NP_305405.1_2490,389,350,175,226,1140
lcl|NC_002695.2_cds_NP_305407.1_2491,390,347,181,222,1140
lcl|NC_002695.2_cds_NP_310703.1_2492,85,61,75,94,315
lcl|NC_002695.2_cds_NP_310704.1_2493,416,338,437,468,1659
lcl|NC_002695.2_cds_NP_310705.1_2494,238,201,264,293,996
lcl|NC_002695.2_cds_NP_310706.2_2495,165,130,187,205,687
lcl|NC_002695.2_cds_NP_310707.1_2496,277,295,381,421,1374
lcl|NC_002695.2_cds_NP_310708.1_2497,137,72,110,125,444
lcl|NC_002695.2_cds_NP_310709.1_2498,301,209,337,281,1128
lcl|NC_002695.2_cds_NP_310710.1_2499,105,112,127,121,465
lcl|NC_002695.2_cds_NP_310711.1_2500,243,229,267,266,1005
lcl|NC_002695.2_cds_NP_310712.1_2501,100,86,100,128,414
lcl|NC_002695.2_cds_NP_310713.2_2502,78,85,99,104,366
lcl|NC_002695.2_cds_NP_310714.1_2503,138,206,194,200,738
lcl|NC_002695.2_cds_NP_310715.1_2504,58,76,67,69,270
lcl|NC_002695.2_cds_NP_310716.1_2505,157,254,189,186,786
lcl|NC_002695.2_cds_NP_310717.1_2506,200,185,118,121,624
lcl|NC_002695.2_cds_NP_310718.1_2507,47,45,35,62,189
lcl|NC_002695.2_cds_NP_310719.3_2508,67,50,49,62,228
lcl|NC_002695.2_cds_NP_310720.1_2509,205,186,200,225,816
lcl|NC_002695.2_cds_NP_310721.1_2510,396,424,423,452,1695
lcl|NC_002695.2_cds_NP_310722.1_2511,40,48,28,67,183
lcl|NC_002695.2_cds_NP_310723.1_2512,199,229,194,296,918
lcl|NC_002695.2_cds_NP_310724.1_2513,163,268,225,265,921
lcl|NC_002695.2_cds_NP_310725.1_2514,101,105,117,148,471
lcl|NC_002695.2_cds_NP_310726.1_2515,351,327,349,392,1419
lcl|NC_002695.2_cds_NP_310727.1_2516,162,152,178,204,696
lcl|NC_002695.2_cds_NP_310732.1_2517,221,216,211,204,852
lcl|NC_002695.2_cds_NP_310733.1_2518,418,397,248,296,1359
lcl|NC_002695.2_cds_NP_310734.3_2519,222,223,140,198,783
lcl|NC_002695.2_cds_NP_310735.1_2520,129,112,91,82,414
lcl|NC_002695.2_cds_NP_310736.1_2521,244,231,263,267,1005
lcl|NC_002695.2_cds_NP_310737.1_2522,144,185,153,154,636
lcl|NC_002695.2_cds_NP_310738.2_2523,221,190,127,134,672
lcl|NC_002695.2_cds_NP_310739.2_2524,144,163,121,103,531
lcl|NC_002695.2_cds_NP_310741.1_2525,271,165,114,104,654
lcl|NC_002695.2_cds_NP_310742.1_2526,278,227,304,205,1014
lcl|NC_002695.2_cds_NP_310743.1_2527,80,54,49,87,270
lcl|NC_002695.2_cds_NP_310744.1_2528,329,193,324,468,1314
lcl|NC_002695.2_cds_NP_310745.1_2529,120,140,152,188,600
lcl|NC_002695.2_cds_NP_305452.1_2530,578,446,617,711,2352
lcl|NC_002695.2_cds_NP_305453.1_2531,263,214,315,384,1176
lcl|NC_002695.2_cds_NP_310748.2_2532,120,106,149,204,579
lcl|NC_002695.2_cds_NP_310749.2_2533,139,159,204,242,744
lcl|NC_002695.2_cds_NP_310750.1_2534,144,146,157,252,699
lcl|NC_002695.2_cds_NP_310751.1_2535,70,71,70,119,330
lcl|NC_002695.2_cds_NP_305458.1_2536,155,149,175,286,765
lcl|NC_002695.2_cds_NP_305459.1_2537,440,333,474,616,1863
lcl|NC_002695.2_cds_NP_310754.2_2538,80,101,96,137,414
lcl|NC_002695.2_cds_NP_310755.1_2539,105,97,103,127,432
lcl|NC_002695.2_cds_NP_310756.3_2540,167,118,139,206,630
lcl|NC_002695.2_cds_NP_310757.1_2541,63,64,65,75,267
lcl|NC_002695.2_cds_NP_310758.1_2542,89,64,88,107,348
lcl|NC_002695.2_cds_NP_310759.1_2543,308,287,405,506,1506
lcl|NC_002695.2_cds_NP_310760.1_2544,347,342,380,524,1593
lcl|NC_002695.2_cds_NP_310761.1_2545,43,48,46,70,207
lcl|NC_002695.2_cds_NP_310762.1_2546,474,434,452,569,1929
lcl|NC_002695.2_cds_NP_310763.1_2547,147,124,108,131,510
lcl|NC_002695.2_cds_NP_310764.1_2548,110,52,59,94,315
lcl|NC_002695.2_cds_NP_310766.2_2549,118,103,117,130,468
lcl|NC_002695.2_cds_NP_310765.2_2550,43,37,56,50,186
lcl|NC_002695.2_cds_YP_009502641.1_2551,24,45,30,33,132
lcl|NC_002695.2_cds_NP_310767.3_2552,46,51,31,55,183
lcl|NC_002695.2_cds_NP_310768.1_2553,127,114,124,169,534
lcl|NC_002695.2_cds_NP_310769.1_2554,94,85,63,103,345
lcl|NC_002695.2_cds_NP_310770.1_2555,48,46,45,68,207
lcl|NC_002695.2_cds_NP_310771.1_2556,75,75,79,98,327
lcl|NC_002695.2_cds_NP_310772.2_2557,219,189,209,271,888
lcl|NC_002695.2_cds_NP_310773.1_2558,436,383,481,551,1851
lcl|NC_002695.2_cds_NP_310775.1_2559,33,46,33,56,168
lcl|NC_002695.2_cds_NP_310776.1_2560,115,95,81,138,429
lcl|NC_002695.2_cds_NP_310777.1_2561,207,167,128,188,690
lcl|NC_002695.2_cds_NP_310778.1_2562,83,84,84,109,360
lcl|NC_002695.2_cds_NP_310779.1_2563,246,239,273,292,1050
lcl|NC_002695.2_cds_NP_310781.1_2564,61,42,51,59,213
lcl|NC_002695.2_cds_NP_310782.1_2565,16,38,15,36,105
lcl|NC_002695.2_cds_NP_310783.1_2566,167,127,120,150,564
lcl|NC_002695.2_cds_NP_310784.1_2567,97,80,47,88,312
lcl|NC_002695.2_cds_NP_310785.2_2568,54,41,15,43,153
lcl|NC_002695.2_cds_NP_310786.1_2569,103,76,72,106,357
lcl|NC_002695.2_cds_NP_310787.1_2570,72,57,43,53,225
lcl|NC_002695.2_cds_NP_310788.1_2571,192,142,161,204,699
lcl|NC_002695.2_cds_NP_310789.2_2572,97,81,99,146,423
lcl|NC_002695.2_cds_NP_310790.1_2573,274,201,240,323,1038
lcl|NC_002695.2_cds_NP_310791.1_2574,103,96,104,123,426
lcl|NC_002695.2_cds_NP_310792.1_2575,62,59,40,67,228
lcl|NC_002695.2_cds_NP_310793.2_2576,198,172,129,146,645
lcl|NC_002695.2_cds_NP_310794.1_2577,46,33,37,37,153
lcl|NC_002695.2_cds_NP_310795.1_2578,54,66,32,37,189
lcl|NC_002695.2_cds_NP_310796.1_2579,62,48,37,42,189
lcl|NC_002695.2_cds_NP_310797.2_2580,750,505,588,629,2472
lcl|NC_002695.2_cds_NP_310799.1_2581,66,51,44,43,204
lcl|NC_002695.2_cds_NP_310800.1_2582,360,219,204,240,1023
lcl|NC_002695.2_cds_NP_310801.2_2583,194,239,177,188,798
lcl|NC_002695.2_cds_NP_310804.1_2584,341,302,190,220,1053
lcl|NC_002695.2_cds_NP_310805.1_2585,259,395,307,356,1317
lcl|NC_002695.2_cds_NP_310806.1_2586,354,375,384,342,1455
lcl|NC_002695.2_cds_NP_310807.1_2587,237,195,127,158,717
lcl|NC_002695.2_cds_NP_310810.1_2588,247,249,208,247,951
lcl|NC_002695.2_cds_NP_310811.1_2589,230,238,217,233,918
lcl|NC_002695.2_cds_NP_310812.2_2590,225,245,222,244,936
lcl|NC_002695.2_cds_NP_310813.1_2591,250,265,246,319,1080
lcl|NC_002695.2_cds_NP_310814.1_2592,129,219,169,227,744
lcl|NC_002695.2_cds_NP_310815.2_2593,133,135,106,169,543
lcl|NC_002695.2_cds_NP_310816.2_2594,103,81,106,91,381
lcl|NC_002695.2_cds_NP_310817.1_2595,69,75,99,105,348
lcl|NC_002695.2_cds_NP_310818.1_2596,345,294,425,475,1539
lcl|NC_002695.2_cds_NP_310819.1_2597,630,546,481,491,2148
lcl|NC_002695.2_cds_NP_310821.1_2598,80,75,78,94,327
lcl|NC_002695.2_cds_NP_310822.2_2599,219,193,210,266,888
lcl|NC_002695.2_cds_NP_310823.2_2600,246,181,212,261,900
lcl|NC_002695.2_cds_NP_310824.1_2601,217,200,224,265,906
lcl|NC_002695.2_cds_NP_310825.1_2602,245,242,256,328,1071
lcl|NC_002695.2_cds_NP_310826.1_2603,193,176,146,169,684
lcl|NC_002695.2_cds_NP_310827.1_2604,136,105,88,82,411
lcl|NC_002695.2_cds_NP_310828.1_2605,191,164,222,245,822
lcl|NC_002695.2_cds_NP_310829.1_2606,111,109,136,124,480
lcl|NC_002695.2_cds_NP_310830.1_2607,107,96,147,127,477
lcl|NC_002695.2_cds_NP_310831.1_2608,48,57,58,59,222
lcl|NC_002695.2_cds_NP_310832.1_2609,82,74,116,97,369
lcl|NC_002695.2_cds_NP_310833.1_2610,59,65,73,67,264
lcl|NC_002695.2_cds_NP_310834.2_2611,52,47,46,50,195
lcl|NC_002695.2_cds_NP_310835.1_2612,101,78,79,99,357
lcl|NC_002695.2_cds_NP_310836.2_2613,110,64,75,81,330
lcl|NC_002695.2_cds_NP_310837.1_2614,240,282,255,282,1059
lcl|NC_002695.2_cds_NP_310838.1_2615,132,119,93,130,474
lcl|NC_002695.2_cds_NP_310839.2_2616,291,301,259,316,1167
lcl|NC_002695.2_cds_NP_310840.1_2617,370,344,351,363,1428
lcl|NC_002695.2_cds_NP_310841.1_2618,66,44,51,67,228
lcl|NC_002695.2_cds_NP_310842.2_2619,195,290,218,302,1005
lcl|NC_002695.2_cds_NP_310843.2_2620,253,389,346,371,1359
lcl|NC_002695.2_cds_NP_310844.3_2621,234,234,222,261,951
lcl|NC_002695.2_cds_NP_310845.1_2622,191,205,196,233,825
lcl|NC_002695.2_cds_NP_310846.1_2623,17,12,16,6,51
lcl|NC_002695.2_cds_NP_310847.1_2624,212,197,246,245,900
lcl|NC_002695.2_cds_NP_310848.1_2625,290,268,373,374,1305
lcl|NC_002695.2_cds_NP_310849.1_2626,252,231,293,295,1071
lcl|NC_002695.2_cds_NP_310850.2_2627,261,238,282,287,1068
lcl|NC_002695.2_cds_NP_310851.1_2628,128,133,155,175,591
lcl|NC_002695.2_cds_NP_310852.2_2629,162,163,178,235,738
lcl|NC_002695.2_cds_NP_310853.1_2630,196,176,185,220,777
lcl|NC_002695.2_cds_NP_310854.1_2631,171,115,168,158,612
lcl|NC_002695.2_cds_NP_310855.3_2632,284,243,193,258,978
lcl|NC_002695.2_cds_NP_310856.1_2633,333,327,257,250,1167
lcl|NC_002695.2_cds_NP_310857.1_2634,352,341,347,367,1407
lcl|NC_002695.2_cds_NP_310858.1_2635,205,216,102,143,666
lcl|NC_002695.2_cds_NP_310862.1_2636,335,294,358,384,1371
lcl|NC_002695.2_cds_NP_310863.1_2637,464,440,238,307,1449
lcl|NC_002695.2_cds_NP_310864.1_2638,158,158,87,107,510
lcl|NC_002695.2_cds_NP_310865.1_2639,296,297,174,199,966
lcl|NC_002695.2_cds_NP_310866.1_2640,338,340,202,239,1119
lcl|NC_002695.2_cds_NP_310867.1_2641,420,413,167,215,1215
lcl|NC_002695.2_cds_NP_310868.2_2642,389,324,170,212,1095
lcl|NC_002695.2_cds_NP_310869.2_2643,457,499,194,242,1392
lcl|NC_002695.2_cds_NP_310870.1_2644,278,245,88,136,747
lcl|NC_002695.2_cds_NP_310871.1_2645,385,445,147,208,1185
lcl|NC_002695.2_cds_NP_310872.1_2646,306,240,96,141,783
lcl|NC_002695.2_cds_NP_310873.1_2647,236,205,216,237,894
lcl|NC_002695.2_cds_NP_310874.1_2648,293,250,226,227,996
lcl|NC_002695.2_cds_NP_310875.1_2649,391,345,330,329,1395
lcl|NC_002695.2_cds_NP_310876.1_2650,292,263,321,345,1221
lcl|NC_002695.2_cds_NP_310877.1_2651,303,285,364,329,1281
lcl|NC_002695.2_cds_NP_310878.1_2652,281,397,355,446,1479
lcl|NC_002695.2_cds_NP_310879.1_2653,312,328,342,413,1395
lcl|NC_002695.2_cds_NP_310880.1_2654,324,293,363,391,1371
lcl|NC_002695.2_cds_NP_310881.1_2655,330,306,361,440,1437
lcl|NC_002695.2_cds_NP_310882.1_2656,288,258,312,366,1224
lcl|NC_002695.2_cds_NP_310883.1_2657,101,113,126,143,483
lcl|NC_002695.2_cds_NP_310884.1_2658,223,197,265,281,966
lcl|NC_002695.2_cds_NP_310885.1_2659,268,244,307,303,1122
lcl|NC_002695.2_cds_NP_310886.1_2660,141,143,117,148,549
lcl|NC_002695.2_cds_NP_310887.1_2661,208,198,161,180,747
lcl|NC_002695.2_cds_NP_310888.1_2662,286,414,240,278,1218
lcl|NC_002695.2_cds_NP_310889.1_2663,284,274,306,354,1218
lcl|NC_002695.2_cds_NP_310890.1_2664,105,121,126,137,489
lcl|NC_002695.2_cds_NP_310891.1_2665,224,186,227,203,840
lcl|NC_002695.2_cds_NP_310892.2_2666,561,459,543,600,2163
lcl|NC_002695.2_cds_NP_310893.1_2667,106,96,117,125,444
lcl|NC_002695.2_cds_NP_310894.1_2668,289,241,316,294,1140
lcl|NC_002695.2_cds_NP_310895.2_2669,353,392,391,448,1584
lcl|NC_002695.2_cds_NP_310896.1_2670,107,89,68,75,339
lcl|NC_002695.2_cds_NP_310897.1_2671,86,77,61,67,291
lcl|NC_002695.2_cds_NP_310898.1_2672,469,410,449,526,1854
lcl|NC_002695.2_cds_NP_310899.1_2673,107,126,156,193,582
lcl|NC_002695.2_cds_NP_310900.2_2674,169,160,154,159,642
lcl|NC_002695.2_cds_NP_310904.1_2675,180,201,200,268,849
lcl|NC_002695.2_cds_NP_310905.3_2676,298,268,332,407,1305
lcl|NC_002695.2_cds_NP_310906.2_2677,447,491,461,542,1941
lcl|NC_002695.2_cds_NP_310907.2_2678,157,188,148,188,681
lcl|NC_002695.2_cds_NP_310908.1_2679,146,169,165,180,660
lcl|NC_002695.2_cds_NP_310909.2_2680,321,236,340,351,1248
lcl|NC_002695.2_cds_NP_310910.1_2681,638,722,891,872,3123
lcl|NC_002695.2_cds_NP_310911.1_2682,628,713,835,902,3078
lcl|NC_002695.2_cds_NP_310912.1_2683,248,384,372,412,1416
lcl|NC_002695.2_cds_NP_310913.1_2684,322,325,368,389,1404
lcl|NC_002695.2_cds_NP_310914.1_2685,168,165,197,193,723
lcl|NC_002695.2_cds_NP_310915.2_2686,104,64,81,84,333
lcl|NC_002695.2_cds_NP_310916.1_2687,333,294,360,375,1362
lcl|NC_002695.2_cds_NP_310918.2_2688,105,89,51,73,318
lcl|NC_002695.2_cds_NP_310919.1_2689,228,224,203,245,900
lcl|NC_002695.2_cds_NP_310920.1_2690,218,198,160,204,780
lcl|NC_002695.2_cds_NP_310921.1_2691,253,283,219,286,1041
lcl|NC_002695.2_cds_NP_310922.1_2692,268,394,305,389,1356
lcl|NC_002695.2_cds_NP_310923.1_2693,75,85,49,76,285
lcl|NC_002695.2_cds_NP_310924.1_2694,130,132,90,101,453
lcl|NC_002695.2_cds_NP_310925.1_2695,324,319,286,334,1263
lcl|NC_002695.2_cds_NP_310926.2_2696,206,195,216,238,855
lcl|NC_002695.2_cds_NP_310927.2_2697,256,257,255,285,1053
lcl|NC_002695.2_cds_NP_310928.1_2698,252,379,315,332,1278
lcl|NC_002695.2_cds_NP_310929.1_2699,219,227,268,291,1005
lcl|NC_002695.2_cds_NP_310930.1_2700,197,225,243,301,966
lcl|NC_002695.2_cds_NP_310931.1_2701,185,181,167,214,747
lcl|NC_002695.2_cds_NP_310932.2_2702,209,213,184,213,819
lcl|NC_002695.2_cds_NP_310933.1_2703,181,179,214,227,801
lcl|NC_002695.2_cds_NP_310934.1_2704,172,187,207,223,789
lcl|NC_002695.2_cds_NP_310935.1_2705,89,43,57,51,240
lcl|NC_002695.2_cds_NP_310936.1_2706,107,99,71,71,348
lcl|NC_002695.2_cds_NP_310937.1_2707,104,85,59,67,315
lcl|NC_002695.2_cds_NP_310938.1_2708,80,63,54,76,273
lcl|NC_002695.2_cds_NP_310939.1_2709,209,208,214,209,840
lcl|NC_002695.2_cds_NP_310940.2_2710,87,80,83,89,339
lcl|NC_002695.2_cds_NP_310941.1_2711,343,299,158,235,1035
lcl|NC_002695.2_cds_NP_310942.1_2712,690,679,477,635,2481
lcl|NC_002695.2_cds_NP_310943.1_2713,231,181,123,140,675
lcl|NC_002695.2_cds_NP_310944.1_2714,159,174,93,117,543
lcl|NC_002695.2_cds_NP_310945.1_2715,82,85,56,59,282
lcl|NC_002695.2_cds_NP_310946.2_2716,274,237,289,310,1110
lcl|NC_002695.2_cds_NP_310947.1_2717,498,466,525,545,2034
lcl|NC_002695.2_cds_NP_310952.1_2718,930,861,927,912,3630
lcl|NC_002695.2_cds_NP_310953.1_2719,102,94,56,66,318
lcl|NC_002695.2_cds_NP_310954.2_2720,246,253,297,293,1089
lcl|NC_002695.2_cds_NP_310957.1_2721,260,261,293,323,1137
lcl|NC_002695.2_cds_NP_310958.1_2722,477,539,601,621,2238
lcl|NC_002695.2_cds_NP_310959.2_2723,219,189,209,271,888
lcl|NC_002695.2_cds_NP_310960.1_2724,75,76,78,98,327
lcl|NC_002695.2_cds_NP_310961.2_2725,149,119,92,102,462
lcl|NC_002695.2_cds_NP_310962.1_2726,125,114,110,122,471
lcl|NC_002695.2_cds_NP_310963.2_2727,180,183,155,202,720
lcl|NC_002695.2_cds_NP_310964.1_2728,395,432,403,456,1686
lcl|NC_002695.2_cds_NP_310966.1_2729,77,60,49,63,249
lcl|NC_002695.2_cds_NP_310967.2_2730,78,54,51,87,270
lcl|NC_002695.2_cds_NP_310968.1_2731,334,192,321,467,1314
lcl|NC_002695.2_cds_NP_310969.1_2732,127,141,145,187,600
lcl|NC_002695.2_cds_NP_305676.1_2733,556,475,612,703,2346
lcl|NC_002695.2_cds_NP_305677.1_2734,263,214,315,384,1176
lcl|NC_002695.2_cds_NP_310972.2_2735,120,106,149,204,579
lcl|NC_002695.2_cds_NP_310973.1_2736,139,159,204,242,744
lcl|NC_002695.2_cds_NP_310974.1_2737,144,146,157,252,699
lcl|NC_002695.2_cds_NP_310975.1_2738,70,71,70,119,330
lcl|NC_002695.2_cds_NP_310976.1_2739,618,498,620,910,2646
lcl|NC_002695.2_cds_NP_310977.1_2740,62,69,73,105,309
lcl|NC_002695.2_cds_NP_310978.1_2741,117,95,101,110,423
lcl|NC_002695.2_cds_NP_310979.1_2742,200,137,175,241,753
lcl|NC_002695.2_cds_NP_310980.1_2743,96,104,77,122,399
lcl|NC_002695.2_cds_NP_310981.1_2744,154,109,169,192,624
lcl|NC_002695.2_cds_NP_310982.1_2745,53,67,63,99,282
lcl|NC_002695.2_cds_NP_310983.1_2746,66,71,77,113,327
lcl|NC_002695.2_cds_NP_310984.2_2747,236,213,257,335,1041
lcl|NC_002695.2_cds_NP_310985.1_2748,75,76,78,98,327
lcl|NC_002695.2_cds_NP_310986.2_2749,219,189,209,271,888
lcl|NC_002695.2_cds_NP_310988.1_2750,354,324,339,486,1503
lcl|NC_002695.2_cds_NP_310989.2_2751,58,35,47,73,213
lcl|NC_002695.2_cds_NP_310990.1_2752,457,448,538,681,2124
lcl|NC_002695.2_cds_NP_310991.1_2753,129,115,99,134,477
lcl|NC_002695.2_cds_NP_310993.2_2754,115,92,124,137,468
lcl|NC_002695.2_cds_NP_310992.2_2755,41,35,56,54,186
lcl|NC_002695.2_cds_YP_009502642.1_2756,28,48,30,41,147
lcl|NC_002695.2_cds_NP_310994.1_2757,169,137,115,149,570
lcl|NC_002695.2_cds_NP_310995.1_2758,128,117,126,163,534
lcl|NC_002695.2_cds_NP_310996.1_2759,53,47,46,70,216
lcl|NC_002695.2_cds_NP_310997.1_2760,62,45,61,78,246
lcl|NC_002695.2_cds_NP_310998.1_2761,43,43,43,51,180
lcl|NC_002695.2_cds_NP_310999.1_2762,466,398,468,615,1947
lcl|NC_002695.2_cds_NP_311000.1_2763,85,83,43,59,270
lcl|NC_002695.2_cds_NP_311001.1_2764,247,308,160,233,948
lcl|NC_002695.2_cds_NP_311002.2_2765,114,121,92,156,483
lcl|NC_002695.2_cds_NP_311003.1_2766,66,43,37,49,195
lcl|NC_002695.2_cds_NP_311004.1_2767,212,99,147,148,606
lcl|NC_002695.2_cds_NP_311005.1_2768,60,47,47,56,210
lcl|NC_002695.2_cds_NP_311006.1_2769,146,89,76,91,402
lcl|NC_002695.2_cds_NP_311007.1_2770,64,30,46,37,177
lcl|NC_002695.2_cds_NP_311008.1_2771,139,119,116,154,528
lcl|NC_002695.2_cds_NP_311009.1_2772,122,87,112,126,447
lcl|NC_002695.2_cds_NP_311010.2_2773,68,50,48,71,237
lcl|NC_002695.2_cds_YP_009502643.1_2774,47,66,45,58,216
lcl|NC_002695.2_cds_NP_311011.1_2775,91,60,46,82,279
lcl|NC_002695.2_cds_NP_311012.1_2776,83,60,56,92,291
lcl|NC_002695.2_cds_NP_311013.1_2777,187,137,177,201,702
lcl|NC_002695.2_cds_NP_311014.1_2778,306,180,222,231,939
lcl|NC_002695.2_cds_NP_311015.1_2779,87,69,66,75,297
lcl|NC_002695.2_cds_NP_311016.1_2780,61,53,53,52,219
lcl|NC_002695.2_cds_NP_311017.2_2781,164,144,142,198,648
lcl|NC_002695.2_cds_NP_311018.1_2782,88,76,54,64,282
lcl|NC_002695.2_cds_NP_311019.1_2783,169,155,102,126,552
lcl|NC_002695.2_cds_NP_311021.1_2784,89,47,64,73,273
lcl|NC_002695.2_cds_NP_311022.1_2785,179,171,107,125,582
lcl|NC_002695.2_cds_NP_311023.1_2786,129,98,63,79,369
lcl|NC_002695.2_cds_NP_311024.1_2787,48,41,41,35,165
lcl|NC_002695.2_cds_NP_311025.2_2788,52,39,26,27,144
lcl|NC_002695.2_cds_NP_305733.1_2789,84,65,70,78,297
lcl|NC_002695.2_cds_NP_311028.1_2790,213,163,206,204,786
lcl|NC_002695.2_cds_NP_311029.1_2791,176,152,160,190,678
lcl|NC_002695.2_cds_NP_311030.2_2792,53,45,43,42,183
lcl|NC_002695.2_cds_NP_311031.1_2793,66,37,42,47,192
lcl|NC_002695.2_cds_NP_311032.2_2794,67,44,53,52,216
lcl|NC_002695.2_cds_NP_311033.1_2795,68,51,43,60,222
lcl|NC_002695.2_cds_NP_311034.1_2796,298,220,181,249,948
lcl|NC_002695.2_cds_NP_305741.1_2797,46,48,41,42,177
lcl|NC_002695.2_cds_NP_311036.1_2798,109,76,81,91,357
lcl|NC_002695.2_cds_NP_311037.1_2799,103,80,71,109,363
lcl|NC_002695.2_cds_NP_311038.1_2800,65,51,60,67,243
lcl|NC_002695.2_cds_YP_009502644.1_2801,27,37,31,40,135
lcl|NC_002695.2_cds_NP_311039.1_2802,89,46,57,63,255
lcl|NC_002695.2_cds_NP_311040.1_2803,417,312,278,280,1287
lcl|NC_002695.2_cds_NP_311041.1_2804,167,134,180,167,648
lcl|NC_002695.2_cds_NP_311042.1_2805,128,189,186,229,732
lcl|NC_002695.2_cds_NP_311043.1_2806,199,216,224,288,927
lcl|NC_002695.2_cds_NP_311044.1_2807,184,314,292,368,1158
lcl|NC_002695.2_cds_NP_311045.1_2808,246,184,237,251,918
lcl|NC_002695.2_cds_NP_311046.2_2809,554,485,558,671,2268
lcl|NC_002695.2_cds_NP_311047.1_2810,426,395,434,461,1716
lcl|NC_002695.2_cds_NP_311048.2_2811,246,211,237,239,933
lcl|NC_002695.2_cds_NP_311049.2_2812,98,178,144,168,588
lcl|NC_002695.2_cds_NP_311050.2_2813,110,159,133,177,579
lcl|NC_002695.2_cds_NP_311051.1_2814,175,171,177,239,762
lcl|NC_002695.2_cds_NP_311052.3_2815,374,324,404,425,1527
lcl|NC_002695.2_cds_NP_311053.1_2816,223,215,213,300,951
lcl|NC_002695.2_cds_NP_311054.1_2817,249,247,290,408,1194
lcl|NC_002695.2_cds_NP_311055.2_2818,160,135,159,191,645
lcl|NC_002695.2_cds_NP_311056.1_2819,155,160,186,201,702
lcl|NC_002695.2_cds_NP_311057.1_2820,228,229,276,296,1029
lcl|NC_002695.2_cds_NP_311058.1_2821,220,365,370,404,1359
lcl|NC_002695.2_cds_NP_311059.2_2822,236,219,225,229,909
lcl|NC_002695.2_cds_NP_311060.1_2823,80,122,88,109,399
lcl|NC_002695.2_cds_NP_311061.1_2824,131,191,179,195,696
lcl|NC_002695.2_cds_NP_311062.1_2825,195,206,236,248,885
lcl|NC_002695.2_cds_NP_311063.1_2826,173,201,171,175,720
lcl|NC_002695.2_cds_NP_311064.1_2827,53,84,46,57,240
lcl|NC_002695.2_cds_NP_311065.1_2828,316,286,298,339,1239
lcl|NC_002695.2_cds_NP_311066.2_2829,305,301,273,357,1236
lcl|NC_002695.2_cds_NP_311067.1_2830,201,299,230,281,1011
lcl|NC_002695.2_cds_NP_311068.1_2831,435,399,312,375,1521
lcl|NC_002695.2_cds_NP_311069.1_2832,288,207,224,280,999
lcl|NC_002695.2_cds_NP_311070.1_2833,247,251,254,289,1041
lcl|NC_002695.2_cds_NP_311071.1_2834,197,339,280,342,1158
lcl|NC_002695.2_cds_NP_311072.1_2835,173,156,175,165,669
lcl|NC_002695.2_cds_NP_311073.1_2836,192,190,225,230,837
lcl|NC_002695.2_cds_NP_311074.1_2837,512,427,501,540,1980
lcl|NC_002695.2_cds_NP_311075.1_2838,277,408,365,420,1470
lcl|NC_002695.2_cds_NP_311076.1_2839,189,220,215,258,882
lcl|NC_002695.2_cds_NP_311077.1_2840,205,287,256,302,1050
lcl|NC_002695.2_cds_NP_311078.1_2841,218,190,232,218,858
lcl|NC_002695.2_cds_NP_311079.1_2842,260,267,264,298,1089
lcl|NC_002695.2_cds_NP_311080.1_2843,251,365,275,360,1251
lcl|NC_002695.2_cds_NP_311081.1_2844,235,219,237,251,942
lcl|NC_002695.2_cds_NP_311082.4_2845,191,206,146,156,699
lcl|NC_002695.2_cds_NP_311083.1_2846,250,362,283,356,1251
lcl|NC_002695.2_cds_NP_311084.1_2847,247,231,214,247,939
lcl|NC_002695.2_cds_NP_311085.1_2848,253,245,196,248,942
lcl|NC_002695.2_cds_NP_311086.1_2849,343,403,409,537,1692
lcl|NC_002695.2_cds_NP_311087.1_2850,210,226,228,275,939
lcl|NC_002695.2_cds_NP_311088.1_2851,273,225,292,341,1131
lcl|NC_002695.2_cds_NP_311089.1_2852,205,349,303,325,1182
lcl|NC_002695.2_cds_YP_009502645.1_2853,56,57,76,66,255
lcl|NC_002695.2_cds_NP_311090.2_2854,157,129,135,152,573
lcl|NC_002695.2_cds_NP_311091.2_2855,360,339,387,390,1476
lcl|NC_002695.2_cds_NP_311092.1_2856,239,209,260,279,987
lcl|NC_002695.2_cds_NP_311093.2_2857,169,231,151,163,714
lcl|NC_002695.2_cds_NP_311094.1_2858,147,154,124,142,567
lcl|NC_002695.2_cds_NP_311095.1_2859,385,384,407,381,1557
lcl|NC_002695.2_cds_NP_311096.2_2860,466,429,470,450,1815
lcl|NC_002695.2_cds_NP_311097.1_2861,217,316,271,291,1095
lcl|NC_002695.2_cds_NP_311098.1_2862,181,301,260,284,1026
lcl|NC_002695.2_cds_NP_311099.1_2863,384,387,407,412,1590
lcl|NC_002695.2_cds_NP_311100.1_2864,82,94,77,92,345
lcl|NC_002695.2_cds_NP_311101.1_2865,197,357,292,345,1191
lcl|NC_002695.2_cds_NP_311102.1_2866,167,160,184,185,696
lcl|NC_002695.2_cds_NP_311103.1_2867,413,413,465,470,1761
lcl|NC_002695.2_cds_NP_311104.1_2868,86,57,72,70,285
lcl|NC_002695.2_cds_NP_311105.1_2869,251,228,233,296,1008
lcl|NC_002695.2_cds_NP_311106.1_2870,65,48,71,44,228
lcl|NC_002695.2_cds_NP_311107.1_2871,394,450,471,446,1761
lcl|NC_002695.2_cds_NP_311108.2_2872,701,635,525,731,2592
lcl|NC_002695.2_cds_NP_311109.1_2873,159,152,153,184,648
lcl|NC_002695.2_cds_NP_311110.1_2874,245,241,251,316,1053
lcl|NC_002695.2_cds_NP_311111.1_2875,126,128,137,167,558
lcl|NC_002695.2_cds_NP_311112.1_2876,307,525,488,624,1944
lcl|NC_002695.2_cds_NP_311113.1_2877,113,108,112,147,480
lcl|NC_002695.2_cds_NP_311114.1_2878,31,59,49,71,210
lcl|NC_002695.2_cds_NP_311115.1_2879,131,198,177,232,738
lcl|NC_002695.2_cds_NP_311116.1_2880,110,185,177,191,663
lcl|NC_002695.2_cds_NP_311117.1_2881,141,136,164,177,618
lcl|NC_002695.2_cds_NP_311118.1_2882,157,135,137,174,603
lcl|NC_002695.2_cds_NP_311119.2_2883,109,89,117,135,450
lcl|NC_002695.2_cds_NP_311120.1_2884,153,227,215,269,864
lcl|NC_002695.2_cds_NP_311121.1_2885,138,146,187,225,696
lcl|NC_002695.2_cds_NP_311122.1_2886,584,502,668,733,2487
lcl|NC_002695.2_cds_NP_311123.1_2887,71,50,63,80,264
lcl|NC_002695.2_cds_NP_311124.1_2888,105,117,144,129,495
lcl|NC_002695.2_cds_YP_009502646.1_2889,52,48,30,35,165
lcl|NC_002695.2_cds_NP_311125.1_2890,136,108,110,135,489
lcl|NC_002695.2_cds_NP_311126.1_2891,405,356,401,485,1647
lcl|NC_002695.2_cds_NP_311127.1_2892,350,418,400,476,1644
lcl|NC_002695.2_cds_NP_311128.1_2893,142,167,168,174,651
lcl|NC_002695.2_cds_NP_311129.1_2894,242,217,305,301,1065
lcl|NC_002695.2_cds_NP_311130.1_2895,273,221,273,289,1056
lcl|NC_002695.2_cds_NP_311131.1_2896,288,257,285,274,1104
lcl|NC_002695.2_cds_NP_311132.1_2897,721,631,649,672,2673
lcl|NC_002695.2_cds_NP_311133.1_2898,187,158,147,159,651
lcl|NC_002695.2_cds_NP_311134.2_2899,673,725,658,794,2850
lcl|NC_002695.2_cds_NP_311135.1_2900,196,174,189,218,777
lcl|NC_002695.2_cds_NP_311138.2_2901,1060,966,1119,1250,4395
lcl|NC_002695.2_cds_NP_311139.2_2902,160,142,153,169,624
lcl|NC_002695.2_cds_NP_311140.3_2903,391,372,391,400,1554
lcl|NC_002695.2_cds_NP_311141.1_2904,648,558,666,756,2628
lcl|NC_002695.2_cds_NP_311142.1_2905,179,152,169,223,723
lcl|NC_002695.2_cds_NP_311143.1_2906,941,886,847,1079,3753
lcl|NC_002695.2_cds_NP_311144.1_2907,553,500,623,610,2286
lcl|NC_002695.2_cds_NP_311145.1_2908,286,268,290,287,1131
lcl|NC_002695.2_cds_NP_311146.1_2909,50,60,70,75,255
lcl|NC_002695.2_cds_NP_311147.1_2910,172,154,134,191,651
lcl|NC_002695.2_cds_NP_311148.1_2911,229,370,266,326,1191
lcl|NC_002695.2_cds_NP_311149.1_2912,266,236,189,188,879
lcl|NC_002695.2_cds_NP_311150.1_2913,439,285,190,157,1071
lcl|NC_002695.2_cds_NP_311151.1_2914,322,262,206,287,1077
lcl|NC_002695.2_cds_NP_311152.1_2915,256,380,322,401,1359
lcl|NC_002695.2_cds_NP_311153.1_2916,348,348,460,473,1629
lcl|NC_002695.2_cds_NP_311154.1_2917,261,294,348,357,1260
lcl|NC_002695.2_cds_NP_311155.1_2918,300,248,331,312,1191
lcl|NC_002695.2_cds_NP_311156.1_2919,247,230,235,215,927
lcl|NC_002695.2_cds_NP_311157.1_2920,166,177,183,227,753
lcl|NC_002695.2_cds_NP_311159.1_2921,75,75,79,98,327
lcl|NC_002695.2_cds_NP_311160.2_2922,219,189,209,271,888
lcl|NC_002695.2_cds_NP_311162.2_2923,287,290,296,333,1206
lcl|NC_002695.2_cds_NP_311163.1_2924,189,199,194,201,783
lcl|NC_002695.2_cds_NP_311164.1_2925,272,282,313,336,1203
lcl|NC_002695.2_cds_NP_311165.2_2926,124,128,120,171,543
lcl|NC_002695.2_cds_NP_311166.1_2927,114,107,90,115,426
lcl|NC_002695.2_cds_NP_311167.1_2928,167,175,125,136,603
lcl|NC_002695.2_cds_NP_311168.4_2929,291,273,305,289,1158
lcl|NC_002695.2_cds_NP_311169.1_2930,233,252,241,243,969
lcl|NC_002695.2_cds_NP_311170.1_2931,477,484,507,515,1983
lcl|NC_002695.2_cds_NP_311171.1_2932,208,210,220,253,891
lcl|NC_002695.2_cds_NP_311172.1_2933,349,463,404,437,1653
lcl|NC_002695.2_cds_YP_009502647.1_2934,60,96,73,107,336
lcl|NC_002695.2_cds_NP_311173.2_2935,78,122,82,105,387
lcl|NC_002695.2_cds_NP_311174.2_2936,79,64,50,74,267
lcl|NC_002695.2_cds_NP_311175.1_2937,267,328,326,435,1356
lcl|NC_002695.2_cds_NP_311176.1_2938,197,200,245,321,963
lcl|NC_002695.2_cds_NP_311177.1_2939,204,184,223,247,858
lcl|NC_002695.2_cds_NP_311178.1_2940,140,187,204,228,759
lcl|NC_002695.2_cds_NP_311179.1_2941,352,342,465,512,1671
lcl|NC_002695.2_cds_NP_311180.2_2942,310,291,342,353,1296
lcl|NC_002695.2_cds_NP_311181.1_2943,75,72,66,93,306
lcl|NC_002695.2_cds_NP_311182.1_2944,115,126,92,129,462
lcl|NC_002695.2_cds_NP_311183.2_2945,229,226,230,233,918
lcl|NC_002695.2_cds_NP_311184.2_2946,470,324,235,192,1221
lcl|NC_002695.2_cds_NP_311186.1_2947,139,137,93,135,504
lcl|NC_002695.2_cds_NP_311187.2_2948,224,397,398,439,1458
lcl|NC_002695.2_cds_NP_311188.1_2949,264,424,409,433,1530
lcl|NC_002695.2_cds_NP_311189.1_2950,303,483,507,549,1842
lcl|NC_002695.2_cds_NP_311190.1_2951,59,80,82,82,303
lcl|NC_002695.2_cds_NP_311191.1_2952,112,149,128,166,555
lcl|NC_002695.2_cds_NP_311192.1_2953,132,117,142,152,543
lcl|NC_002695.2_cds_NP_311193.1_2954,169,275,248,286,978
lcl|NC_002695.2_cds_NP_311194.2_2955,608,583,733,803,2727
lcl|NC_002695.2_cds_NP_311195.1_2956,312,269,353,404,1338
lcl|NC_002695.2_cds_NP_311196.1_2957,126,95,129,151,501
lcl|NC_002695.2_cds_NP_311197.3_2958,395,397,513,498,1803
lcl|NC_002695.2_cds_NP_311198.1_2959,154,165,162,182,663
lcl|NC_002695.2_cds_NP_311199.3_2960,78,130,113,123,444
lcl|NC_002695.2_cds_NP_311200.1_2961,222,250,223,244,939
lcl|NC_002695.2_cds_NP_311201.1_2962,298,306,303,311,1218
lcl|NC_002695.2_cds_NP_311202.1_2963,163,138,146,153,600
lcl|NC_002695.2_cds_NP_311203.1_2964,336,540,402,555,1833
lcl|NC_002695.2_cds_NP_311204.1_2965,132,152,161,206,651
lcl|NC_002695.2_cds_NP_311205.2_2966,129,126,121,119,495
lcl|NC_002695.2_cds_NP_311206.2_2967,95,129,115,117,456
lcl|NC_002695.2_cds_NP_311207.1_2968,302,270,322,309,1203
lcl|NC_002695.2_cds_NP_311208.1_2969,483,474,615,573,2145
lcl|NC_002695.2_cds_NP_311209.3_2970,270,432,357,420,1479
lcl|NC_002695.2_cds_NP_311210.1_2971,137,115,128,163,543
lcl|NC_002695.2_cds_NP_311211.4_2972,131,137,130,154,552
lcl|NC_002695.2_cds_NP_311212.1_2973,151,169,147,178,645
lcl|NC_002695.2_cds_NP_311213.1_2974,155,157,166,170,648
lcl|NC_002695.2_cds_NP_311214.1_2975,112,90,82,79,363
lcl|NC_002695.2_cds_NP_311215.1_2976,199,205,231,259,894
lcl|NC_002695.2_cds_NP_311216.1_2977,247,241,192,211,891
lcl|NC_002695.2_cds_NP_311217.1_2978,206,158,180,230,774
lcl|NC_002695.2_cds_NP_311218.1_2979,141,218,180,178,717
lcl|NC_002695.2_cds_NP_311219.1_2980,123,202,154,208,687
lcl|NC_002695.2_cds_NP_311220.1_2981,219,183,184,197,783
lcl|NC_002695.2_cds_NP_311221.1_2982,193,190,188,212,783
lcl|NC_002695.2_cds_NP_311222.1_2983,119,150,150,151,570
lcl|NC_002695.2_cds_NP_311223.1_2984,355,361,404,398,1518
lcl|NC_002695.2_cds_NP_311224.1_2985,86,162,107,134,489
lcl|NC_002695.2_cds_NP_311225.2_2986,159,125,165,214,663
lcl|NC_002695.2_cds_NP_311226.1_2987,273,286,314,396,1269
lcl|NC_002695.2_cds_NP_311227.1_2988,207,201,224,283,915
lcl|NC_002695.2_cds_NP_311228.1_2989,136,204,153,167,660
lcl|NC_002695.2_cds_NP_311229.1_2990,186,174,209,244,813
lcl|NC_002695.2_cds_NP_311230.1_2991,232,227,248,307,1014
lcl|NC_002695.2_cds_NP_311231.1_2992,253,282,268,334,1137
lcl|NC_002695.2_cds_NP_311232.1_2993,247,224,266,259,996
lcl|NC_002695.2_cds_NP_311233.1_2994,181,330,299,369,1179
lcl|NC_002695.2_cds_NP_311234.1_2995,261,273,332,355,1221
lcl|NC_002695.2_cds_NP_311235.2_2996,475,499,471,562,2007
lcl|NC_002695.2_cds_NP_311236.1_2997,65,68,62,84,279
lcl|NC_002695.2_cds_NP_311237.1_2998,135,131,136,147,549
lcl|NC_002695.2_cds_NP_311238.1_2999,157,232,195,226,810
lcl|NC_002695.2_cds_NP_311239.1_3000,188,180,232,225,825
lcl|NC_002695.2_cds_NP_311240.1_3001,251,234,289,312,1086
lcl|NC_002695.2_cds_NP_311242.2_3002,218,221,242,252,933
lcl|NC_002695.2_cds_NP_311241.3_3003,139,124,129,160,552
lcl|NC_002695.2_cds_NP_311243.1_3004,231,251,179,182,843
lcl|NC_002695.2_cds_NP_311244.2_3005,139,150,111,122,522
lcl|NC_002695.2_cds_NP_311245.2_3006,117,109,96,107,429
lcl|NC_002695.2_cds_NP_311246.1_3007,110,136,109,146,501
lcl|NC_002695.2_cds_NP_311247.1_3008,204,154,199,202,759
lcl|NC_002695.2_cds_NP_311248.1_3009,643,557,707,733,2640
lcl|NC_002695.2_cds_NP_311249.1_3010,162,135,139,128,564
lcl|NC_002695.2_cds_NP_311250.1_3011,105,121,118,142,486
lcl|NC_002695.2_cds_NP_311251.1_3012,521,515,501,608,2145
lcl|NC_002695.2_cds_NP_311252.1_3013,279,300,341,391,1311
lcl|NC_002695.2_cds_NP_311253.2_3014,68,69,71,77,285
lcl|NC_002695.2_cds_NP_311254.2_3015,325,340,338,338,1341
lcl|NC_002695.2_cds_NP_311255.1_3016,406,268,177,181,1032
lcl|NC_002695.2_cds_NP_311256.1_3017,158,203,185,210,756
lcl|NC_002695.2_cds_NP_311257.1_3018,257,223,208,245,933
lcl|NC_002695.2_cds_NP_311258.1_3019,343,261,253,301,1158
lcl|NC_002695.2_cds_NP_311259.1_3020,326,329,215,267,1137
lcl|NC_002695.2_cds_NP_311260.1_3021,186,152,163,180,681
lcl|NC_002695.2_cds_NP_311261.1_3022,134,120,106,108,468
lcl|NC_002695.2_cds_NP_311263.2_3023,238,131,132,147,648
lcl|NC_002695.2_cds_NP_311265.1_3024,461,440,220,292,1413
lcl|NC_002695.2_cds_NP_311266.1_3025,51,50,34,42,177
lcl|NC_002695.2_cds_NP_311267.1_3026,204,125,129,169,627
lcl|NC_002695.2_cds_NP_311268.1_3027,272,428,253,295,1248
lcl|NC_002695.2_cds_NP_311269.1_3028,213,224,197,281,915
lcl|NC_002695.2_cds_NP_311270.1_3029,363,336,349,386,1434
lcl|NC_002695.2_cds_NP_311271.2_3030,208,255,239,252,954
lcl|NC_002695.2_cds_NP_311272.1_3031,313,336,310,370,1329
lcl|NC_002695.2_cds_NP_311273.1_3032,382,514,302,341,1539
lcl|NC_002695.2_cds_NP_311274.1_3033,369,309,228,258,1164
lcl|NC_002695.2_cds_NP_311275.1_3034,201,168,119,127,615
lcl|NC_002695.2_cds_NP_311276.1_3035,1129,993,767,705,3594
lcl|NC_002695.2_cds_NP_311279.1_3036,210,309,199,227,945
lcl|NC_002695.2_cds_NP_311280.1_3037,460,440,376,419,1695
lcl|NC_002695.2_cds_NP_311281.1_3038,335,325,281,310,1251
lcl|NC_002695.2_cds_NP_311282.1_3039,203,141,129,163,636
lcl|NC_002695.2_cds_NP_311283.1_3040,87,82,56,51,276
lcl|NC_002695.2_cds_NP_311284.1_3041,41,87,46,69,243
lcl|NC_002695.2_cds_NP_311285.2_3042,216,229,229,247,921
lcl|NC_002695.2_cds_NP_311286.1_3043,279,275,325,360,1239
lcl|NC_002695.2_cds_NP_311287.1_3044,403,432,422,441,1698
lcl|NC_002695.2_cds_NP_311288.1_3045,208,180,172,175,735
lcl|NC_002695.2_cds_NP_311289.1_3046,171,230,222,235,858
lcl|NC_002695.2_cds_NP_311290.1_3047,573,537,663,723,2496
lcl|NC_002695.2_cds_NP_311291.1_3048,215,220,271,332,1038
lcl|NC_002695.2_cds_NP_311292.1_3049,236,230,292,328,1086
lcl|NC_002695.2_cds_NP_311293.1_3050,231,346,329,342,1248
lcl|NC_002695.2_cds_NP_311294.1_3051,96,65,80,86,327
lcl|NC_002695.2_cds_NP_311295.1_3052,215,257,224,270,966
lcl|NC_002695.2_cds_NP_311296.1_3053,235,343,326,353,1257
lcl|NC_002695.2_cds_NP_311297.1_3054,82,71,82,92,327
lcl|NC_002695.2_cds_NP_311298.1_3055,232,348,279,380,1239
lcl|NC_002695.2_cds_NP_311299.1_3056,255,354,304,290,1203
lcl|NC_002695.2_cds_NP_311300.1_3057,478,640,504,568,2190
lcl|NC_002695.2_cds_NP_311301.3_3058,104,77,79,100,360
lcl|NC_002695.2_cds_NP_311302.2_3059,109,84,90,89,372
lcl|NC_002695.2_cds_NP_311303.3_3060,315,239,284,311,1149
lcl|NC_002695.2_cds_NP_311304.1_3061,146,146,124,127,543
lcl|NC_002695.2_cds_NP_311305.1_3062,347,318,358,393,1416
lcl|NC_002695.2_cds_NP_311306.1_3063,119,73,81,69,342
lcl|NC_002695.2_cds_NP_311309.1_3064,187,296,238,278,999
lcl|NC_002695.2_cds_YP_009502648.1_3065,61,45,51,62,219
lcl|NC_002695.2_cds_NP_311310.1_3066,462,459,479,616,2016
lcl|NC_002695.2_cds_NP_311311.1_3067,237,209,282,271,999
lcl|NC_002695.2_cds_NP_311312.1_3068,151,232,188,191,762
lcl|NC_002695.2_cds_NP_311313.1_3069,262,222,234,254,972
lcl|NC_002695.2_cds_NP_311314.1_3070,74,54,66,64,258
lcl|NC_002695.2_cds_NP_311315.1_3071,462,410,399,457,1728
lcl|NC_002695.2_cds_NP_311316.1_3072,142,127,112,129,510
lcl|NC_002695.2_cds_NP_311317.1_3073,203,206,200,243,852
lcl|NC_002695.2_cds_NP_311318.1_3074,92,84,76,81,333
lcl|NC_002695.2_cds_NP_311319.1_3075,214,189,217,292,912
lcl|NC_002695.2_cds_NP_311320.1_3076,228,233,301,336,1098
lcl|NC_002695.2_cds_NP_311321.2_3077,160,225,220,271,876
lcl|NC_002695.2_cds_NP_311322.1_3078,140,234,205,255,834
lcl|NC_002695.2_cds_NP_311323.1_3079,275,198,273,271,1017
lcl|NC_002695.2_cds_NP_311324.2_3080,185,172,192,243,792
lcl|NC_002695.2_cds_NP_311325.1_3081,226,190,202,240,858
lcl|NC_002695.2_cds_NP_311326.1_3082,218,195,217,267,897
lcl|NC_002695.2_cds_NP_311327.1_3083,261,362,387,415,1425
lcl|NC_002695.2_cds_NP_311328.1_3084,337,290,326,352,1305
lcl|NC_002695.2_cds_NP_311329.2_3085,205,191,224,280,900
lcl|NC_002695.2_cds_NP_311330.1_3086,150,135,126,165,576
lcl|NC_002695.2_cds_NP_311331.2_3087,68,144,102,136,450
lcl|NC_002695.2_cds_NP_311332.2_3088,99,103,84,140,426
lcl|NC_002695.2_cds_NP_311333.1_3089,238,193,219,220,870
lcl|NC_002695.2_cds_NP_311334.1_3090,190,219,233,258,900
lcl|NC_002695.2_cds_NP_311335.1_3091,253,240,255,305,1053
lcl|NC_002695.2_cds_NP_311336.2_3092,107,106,129,159,501
lcl|NC_002695.2_cds_NP_311337.1_3093,136,156,178,190,660
lcl|NC_002695.2_cds_NP_311338.1_3094,200,186,234,268,888
lcl|NC_002695.2_cds_NP_311339.1_3095,333,270,364,395,1362
lcl|NC_002695.2_cds_NP_311340.1_3096,262,313,406,423,1404
lcl|NC_002695.2_cds_NP_311341.1_3097,237,312,318,360,1227
lcl|NC_002695.2_cds_NP_311342.2_3098,236,253,313,386,1188
lcl|NC_002695.2_cds_NP_311343.1_3099,173,174,222,268,837
lcl|NC_002695.2_cds_NP_311344.1_3100,327,274,377,426,1404
lcl|NC_002695.2_cds_NP_311345.1_3101,67,67,64,90,288
lcl|NC_002695.2_cds_NP_311346.3_3102,74,69,82,111,336
lcl|NC_002695.2_cds_NP_311347.1_3103,211,215,281,310,1017
lcl|NC_002695.2_cds_NP_311348.1_3104,168,142,206,216,732
lcl|NC_002695.2_cds_NP_311349.1_3105,178,137,183,204,702
lcl|NC_002695.2_cds_NP_311350.1_3106,133,101,113,133,480
lcl|NC_002695.2_cds_NP_311351.2_3107,86,79,76,95,336
lcl|NC_002695.2_cds_NP_311352.1_3108,537,505,576,662,2280
lcl|NC_002695.2_cds_NP_311353.1_3109,256,216,234,245,951
lcl|NC_002695.2_cds_NP_311354.1_3110,477,435,493,599,2004
lcl|NC_002695.2_cds_NP_311355.1_3111,225,244,257,318,1044
lcl|NC_002695.2_cds_NP_311356.1_3112,164,134,128,150,576
lcl|NC_002695.2_cds_NP_311357.1_3113,449,429,518,584,1980
lcl|NC_002695.2_cds_NP_311358.1_3114,402,420,428,451,1701
lcl|NC_002695.2_cds_NP_311359.1_3115,685,742,809,878,3114
lcl|NC_002695.2_cds_NP_311360.1_3116,96,93,84,84,357
lcl|NC_002695.2_cds_NP_311361.1_3117,255,273,276,324,1128
lcl|NC_002695.2_cds_YP_009502649.1_3118,56,48,43,54,201
lcl|NC_002695.2_cds_NP_311362.2_3119,155,166,158,220,699
lcl|NC_002695.2_cds_NP_311363.1_3120,424,484,524,584,2016
lcl|NC_002695.2_cds_NP_311364.1_3121,213,184,207,260,864
lcl|NC_002695.2_cds_NP_311365.1_3122,185,155,164,210,714
lcl|NC_002695.2_cds_NP_311366.2_3123,229,233,270,303,1035
lcl|NC_002695.2_cds_NP_311367.1_3124,212,211,209,247,879
lcl|NC_002695.2_cds_NP_311368.2_3125,144,143,144,142,573
lcl|NC_002695.2_cds_NP_311369.1_3126,129,108,115,119,471
lcl|NC_002695.2_cds_NP_311370.2_3127,136,132,181,169,618
lcl|NC_002695.2_cds_NP_311371.1_3128,359,546,540,574,2019
lcl|NC_002695.2_cds_NP_311372.2_3129,167,271,250,260,948
lcl|NC_002695.2_cds_NP_311373.1_3130,231,405,380,424,1440
lcl|NC_002695.2_cds_NP_311374.1_3131,130,173,172,176,651
lcl|NC_002695.2_cds_NP_311375.2_3132,275,441,414,436,1566
lcl|NC_002695.2_cds_NP_311376.1_3133,365,414,456,481,1716
lcl|NC_002695.2_cds_NP_311377.1_3134,135,107,161,143,546
lcl|NC_002695.2_cds_NP_311378.1_3135,155,177,222,205,759
lcl|NC_002695.2_cds_NP_311379.2_3136,96,103,94,121,414
lcl|NC_002695.2_cds_NP_311380.2_3137,478,473,526,536,2013
lcl|NC_002695.2_cds_NP_311381.1_3138,161,260,204,224,849
lcl|NC_002695.2_cds_NP_311382.1_3139,184,310,253,315,1062
lcl|NC_002695.2_cds_NP_311383.1_3140,359,315,390,400,1464
lcl|NC_002695.2_cds_NP_311384.1_3141,102,68,81,109,360
lcl|NC_002695.2_cds_NP_311385.1_3142,155,195,176,221,747
lcl|NC_002695.2_cds_NP_311386.1_3143,246,367,319,358,1290
lcl|NC_002695.2_cds_NP_311387.2_3144,168,126,153,180,627
lcl|NC_002695.2_cds_NP_311388.1_3145,243,243,245,307,1038
lcl|NC_002695.2_cds_NP_311389.1_3146,145,149,169,176,639
lcl|NC_002695.2_cds_NP_311390.1_3147,527,530,516,494,2067
lcl|NC_002695.2_cds_NP_311391.1_3148,387,367,368,420,1542
lcl|NC_002695.2_cds_NP_311392.1_3149,537,664,508,535,2244
lcl|NC_002695.2_cds_NP_311393.2_3150,45,44,52,33,174
lcl|NC_002695.2_cds_NP_311394.2_3151,150,123,117,126,516
lcl|NC_002695.2_cds_NP_311395.1_3152,188,88,120,144,540
lcl|NC_002695.2_cds_NP_311396.1_3153,362,361,410,445,1578
lcl|NC_002695.2_cds_NP_311397.1_3154,334,334,376,423,1467
lcl|NC_002695.2_cds_NP_311398.1_3155,352,285,372,362,1371
lcl|NC_002695.2_cds_NP_311399.1_3156,54,57,48,57,216
lcl|NC_002695.2_cds_NP_311400.2_3157,363,348,338,424,1473
lcl|NC_002695.2_cds_NP_311401.1_3158,259,293,283,344,1179
lcl|NC_002695.2_cds_NP_311402.1_3159,172,141,131,177,621
lcl|NC_002695.2_cds_NP_311403.1_3160,283,295,313,384,1275
lcl|NC_002695.2_cds_NP_311404.1_3161,272,252,280,315,1119
lcl|NC_002695.2_cds_NP_311405.1_3162,257,204,282,271,1014
lcl|NC_002695.2_cds_NP_311406.1_3163,290,257,286,322,1155
lcl|NC_002695.2_cds_NP_311407.1_3164,98,106,116,112,432
lcl|NC_002695.2_cds_NP_311408.1_3165,214,237,190,214,855
lcl|NC_002695.2_cds_NP_311409.1_3166,158,265,174,225,822
lcl|NC_002695.2_cds_NP_311410.1_3167,153,163,134,180,630
lcl|NC_002695.2_cds_NP_311411.1_3168,636,555,580,611,2382
lcl|NC_002695.2_cds_NP_311412.1_3169,467,542,614,690,2313
lcl|NC_002695.2_cds_NP_311413.1_3170,1205,1121,1213,1423,4962
lcl|NC_002695.2_cds_NP_311414.2_3171,198,202,195,251,846
lcl|NC_002695.2_cds_NP_311415.2_3172,222,191,167,197,777
lcl|NC_002695.2_cds_NP_311416.2_3173,299,265,325,395,1284
lcl|NC_002695.2_cds_NP_311417.1_3174,55,45,46,55,201
lcl|NC_002695.2_cds_NP_311418.1_3175,84,76,87,89,336
lcl|NC_002695.2_cds_NP_311419.1_3176,384,399,493,575,1851
lcl|NC_002695.2_cds_NP_311420.1_3177,132,116,133,135,516
lcl|NC_002695.2_cds_NP_311421.1_3178,86,76,67,95,324
lcl|NC_002695.2_cds_NP_311422.1_3179,115,82,88,102,387
lcl|NC_002695.2_cds_NP_311423.2_3180,296,272,321,326,1215
lcl|NC_002695.2_cds_NP_311424.1_3181,109,119,125,136,489
lcl|NC_002695.2_cds_NP_311425.1_3182,166,167,180,225,738
lcl|NC_002695.2_cds_NP_311426.1_3183,188,179,221,216,804
lcl|NC_002695.2_cds_NP_311427.2_3184,196,227,224,208,855
lcl|NC_002695.2_cds_NP_311428.2_3185,295,330,339,317,1281
lcl|NC_002695.2_cds_NP_311429.1_3186,168,329,292,351,1140
lcl|NC_002695.2_cds_NP_311430.1_3187,224,221,203,243,891
lcl|NC_002695.2_cds_NP_311431.1_3188,320,314,357,371,1362
lcl|NC_002695.2_cds_NP_311432.1_3189,134,112,139,134,519
lcl|NC_002695.2_cds_NP_311433.1_3190,66,77,86,92,321
lcl|NC_002695.2_cds_NP_311434.1_3191,170,189,215,239,813
lcl|NC_002695.2_cds_NP_311435.1_3192,283,269,313,338,1203
lcl|NC_002695.2_cds_NP_311436.2_3193,75,136,99,113,423
lcl|NC_002695.2_cds_NP_311437.1_3194,176,209,216,272,873
lcl|NC_002695.2_cds_NP_311439.1_3195,152,286,244,317,999
lcl|NC_002695.2_cds_NP_311440.1_3196,348,321,367,476,1512
lcl|NC_002695.2_cds_NP_311441.1_3197,287,247,195,255,984
lcl|NC_002695.2_cds_NP_311442.2_3198,768,713,859,942,3282
lcl|NC_002695.2_cds_NP_311443.2_3199,309,280,270,335,1194
lcl|NC_002695.2_cds_NP_311444.1_3200,314,276,321,343,1254
lcl|NC_002695.2_cds_NP_311445.1_3201,306,258,299,328,1191
lcl|NC_002695.2_cds_NP_311446.1_3202,89,77,76,97,339
lcl|NC_002695.2_cds_NP_311447.1_3203,313,298,335,389,1335
lcl|NC_002695.2_cds_NP_311448.1_3204,187,142,206,179,714
lcl|NC_002695.2_cds_NP_311449.2_3205,333,322,333,395,1383
lcl|NC_002695.2_cds_NP_311450.1_3206,829,847,1039,1173,3888
lcl|NC_002695.2_cds_NP_311451.2_3207,406,362,386,403,1557
lcl|NC_002695.2_cds_NP_311452.2_3208,119,116,113,156,504
lcl|NC_002695.2_cds_NP_311453.2_3209,125,172,160,179,636
lcl|NC_002695.2_cds_NP_311454.2_3210,209,200,211,229,849
lcl|NC_002695.2_cds_NP_311455.1_3211,86,60,52,63,261
lcl|NC_002695.2_cds_NP_311456.1_3212,100,85,82,114,381
lcl|NC_002695.2_cds_NP_311457.1_3213,171,146,192,223,732
lcl|NC_002695.2_cds_NP_311458.1_3214,166,171,195,197,729
lcl|NC_002695.2_cds_NP_311459.1_3215,236,196,228,246,906
lcl|NC_002695.2_cds_NP_311460.1_3216,176,160,162,183,681
lcl|NC_002695.2_cds_NP_311461.1_3217,237,234,225,279,975
lcl|NC_002695.2_cds_NP_311462.1_3218,444,388,467,501,1800
lcl|NC_002695.2_cds_NP_311463.1_3219,90,123,124,143,480
lcl|NC_002695.2_cds_NP_311464.1_3220,228,243,249,237,957
lcl|NC_002695.2_cds_NP_311465.1_3221,178,129,169,163,639
lcl|NC_002695.2_cds_NP_311466.1_3222,146,149,118,163,576
lcl|NC_002695.2_cds_NP_311467.1_3223,372,391,408,452,1623
lcl|NC_002695.2_cds_NP_311468.2_3224,165,180,170,223,738
lcl|NC_002695.2_cds_NP_311469.1_3225,347,257,362,369,1335
lcl|NC_002695.2_cds_NP_311470.2_3226,212,232,191,247,882
lcl|NC_002695.2_cds_NP_311471.1_3227,117,172,135,164,588
lcl|NC_002695.2_cds_NP_311472.1_3228,106,91,86,101,384
lcl|NC_002695.2_cds_NP_311473.2_3229,163,163,180,184,690
lcl|NC_002695.2_cds_NP_311474.1_3230,251,203,252,332,1038
lcl|NC_002695.2_cds_NP_311475.1_3231,109,103,93,115,420
lcl|NC_002695.2_cds_NP_311476.2_3232,157,175,193,174,699
lcl|NC_002695.2_cds_NP_306183.1_3233,602,605,709,745,2661
lcl|NC_002695.2_cds_NP_311479.2_3234,352,342,331,331,1356
lcl|NC_002695.2_cds_NP_311480.1_3235,59,61,65,88,273
lcl|NC_002695.2_cds_NP_311481.1_3236,269,396,287,347,1299
lcl|NC_002695.2_cds_NP_311482.1_3237,662,588,601,723,2574
lcl|NC_002695.2_cds_NP_311483.1_3238,151,183,181,217,732
lcl|NC_002695.2_cds_NP_311484.1_3239,243,224,247,267,981
lcl|NC_002695.2_cds_NP_311485.1_3240,197,163,188,190,738
lcl|NC_002695.2_cds_NP_311487.1_3241,119,65,85,73,342
lcl|NC_002695.2_cds_NP_311488.1_3242,10,19,15,4,48
lcl|NC_002695.2_cds_NP_311489.1_3243,308,284,284,285,1161
lcl|NC_002695.2_cds_NP_311490.1_3244,248,293,242,339,1122
lcl|NC_002695.2_cds_NP_311491.1_3245,267,247,268,289,1071
lcl|NC_002695.2_cds_NP_311492.3_3246,110,86,80,87,363
lcl|NC_002695.2_cds_NP_311493.1_3247,133,149,126,111,519
lcl|NC_002695.2_cds_NP_311494.1_3248,329,302,314,282,1227
lcl|NC_002695.2_cds_NP_311495.1_3249,136,99,134,114,483
lcl|NC_002695.2_cds_NP_311496.1_3250,88,92,78,90,348
lcl|NC_002695.2_cds_NP_311497.1_3251,192,168,178,230,768
lcl|NC_002695.2_cds_NP_311498.3_3252,145,135,122,147,549
lcl|NC_002695.2_cds_NP_311499.1_3253,62,59,64,64,249
lcl|NC_002695.2_cds_NP_311500.1_3254,346,278,321,417,1362
lcl|NC_002695.2_cds_NP_311501.3_3255,173,246,230,218,867
lcl|NC_002695.2_cds_NP_311502.2_3256,298,305,296,343,1242
lcl|NC_002695.2_cds_NP_311503.1_3257,167,129,118,180,594
lcl|NC_002695.2_cds_NP_311504.1_3258,229,212,227,211,879
lcl|NC_002695.2_cds_NP_311505.1_3259,441,357,439,425,1662
lcl|NC_002695.2_cds_NP_311506.2_3260,91,82,85,84,342
lcl|NC_002695.2_cds_NP_311507.2_3261,81,62,64,84,291
lcl|NC_002695.2_cds_NP_311508.2_3262,106,127,92,125,450
lcl|NC_002695.2_cds_NP_311509.1_3263,140,98,121,124,483
lcl|NC_002695.2_cds_NP_311510.1_3264,81,59,49,60,249
lcl|NC_002695.2_cds_NP_311512.1_3265,196,168,91,136,591
lcl|NC_002695.2_cds_NP_311513.1_3266,200,184,137,130,651
lcl|NC_002695.2_cds_NP_311514.1_3267,411,270,198,180,1059
lcl|NC_002695.2_cds_NP_311516.2_3268,79,52,52,87,270
lcl|NC_002695.2_cds_NP_311517.1_3269,75,75,79,98,327
lcl|NC_002695.2_cds_NP_311518.2_3270,219,189,209,271,888
lcl|NC_002695.2_cds_NP_311520.1_3271,69,75,99,105,348
lcl|NC_002695.2_cds_NP_311521.1_3272,102,81,107,91,381
lcl|NC_002695.2_cds_NP_306228.1_3273,53,48,57,73,231
lcl|NC_002695.2_cds_NP_311523.1_3274,95,88,61,101,345
lcl|NC_002695.2_cds_NP_311524.1_3275,53,46,45,72,216
lcl|NC_002695.2_cds_NP_311525.1_3276,441,388,472,553,1854
lcl|NC_002695.2_cds_NP_311526.1_3277,98,84,87,61,330
lcl|NC_002695.2_cds_NP_311527.3_3278,180,292,101,171,744
lcl|NC_002695.2_cds_NP_311528.1_3279,176,131,148,169,624
lcl|NC_002695.2_cds_NP_311529.1_3280,210,156,136,164,666
lcl|NC_002695.2_cds_NP_311530.1_3281,220,109,133,150,612
lcl|NC_002695.2_cds_NP_311531.1_3282,196,147,88,136,567
lcl|NC_002695.2_cds_NP_306238.1_3283,238,165,170,183,756
lcl|NC_002695.2_cds_NP_311533.2_3284,101,73,63,66,303
lcl|NC_002695.2_cds_NP_311534.2_3285,470,338,212,243,1263
lcl|NC_002695.2_cds_NP_311535.1_3286,152,126,57,79,414
lcl|NC_002695.2_cds_NP_311536.1_3287,154,109,60,76,399
lcl|NC_002695.2_cds_NP_311537.1_3288,603,515,226,288,1632
lcl|NC_002695.2_cds_NP_311538.1_3289,504,399,179,232,1314
lcl|NC_002695.2_cds_NP_311539.1_3290,458,338,160,250,1206
lcl|NC_002695.2_cds_NP_311540.1_3291,61,58,49,39,207
lcl|NC_002695.2_cds_NP_311541.1_3292,265,221,183,183,852
lcl|NC_002695.2_cds_NP_311542.2_3293,1325,995,1002,1265,4587
lcl|NC_002695.2_cds_NP_311544.1_3294,464,419,192,275,1350
lcl|NC_002695.2_cds_NP_311545.1_3295,439,327,248,225,1239
lcl|NC_002695.2_cds_NP_311546.1_3296,347,277,192,192,1008
lcl|NC_002695.2_cds_NP_311547.2_3297,229,229,259,261,978
lcl|NC_002695.2_cds_NP_311548.2_3298,270,268,358,373,1269
lcl|NC_002695.2_cds_NP_311549.1_3299,332,286,397,434,1449
lcl|NC_002695.2_cds_NP_311550.1_3300,271,261,344,405,1281
lcl|NC_002695.2_cds_NP_311551.1_3301,280,402,344,375,1401
lcl|NC_002695.2_cds_NP_311552.2_3302,145,164,147,207,663
lcl|NC_002695.2_cds_NP_311553.1_3303,135,99,91,125,450
lcl|NC_002695.2_cds_NP_311554.1_3304,28,50,38,43,159
lcl|NC_002695.2_cds_NP_311555.1_3305,79,62,85,74,300
lcl|NC_002695.2_cds_NP_311556.1_3306,138,142,109,130,519
lcl|NC_002695.2_cds_NP_311557.1_3307,126,84,93,102,405
lcl|NC_002695.2_cds_NP_311558.1_3308,91,137,98,124,450
lcl|NC_002695.2_cds_NP_311559.1_3309,89,94,75,87,345
lcl|NC_002695.2_cds_NP_311560.2_3310,79,75,74,102,330
lcl|NC_002695.2_cds_NP_311561.1_3311,291,326,317,401,1335
lcl|NC_002695.2_cds_NP_311562.1_3312,109,100,107,116,432
lcl|NC_002695.2_cds_NP_311563.1_3313,51,64,62,69,246
lcl|NC_002695.2_cds_NP_311564.1_3314,89,91,109,122,411
lcl|NC_002695.2_cds_NP_311565.1_3315,529,500,562,554,2145
lcl|NC_002695.2_cds_NP_311566.1_3316,254,240,232,234,960
lcl|NC_002695.2_cds_NP_311567.1_3317,320,299,273,311,1203
lcl|NC_002695.2_cds_NP_311568.1_3318,174,270,301,320,1065
lcl|NC_002695.2_cds_NP_311569.1_3319,270,199,260,264,993
lcl|NC_002695.2_cds_NP_311570.1_3320,210,323,329,323,1185
lcl|NC_002695.2_cds_NP_311571.1_3321,136,213,192,197,738
lcl|NC_002695.2_cds_NP_311572.1_3322,61,90,91,94,336
lcl|NC_002695.2_cds_NP_311573.1_3323,147,123,133,128,531
lcl|NC_002695.2_cds_NP_311574.1_3324,306,241,314,312,1173
lcl|NC_002695.2_cds_NP_311575.1_3325,287,387,415,450,1539
lcl|NC_002695.2_cds_NP_311576.1_3326,134,116,118,148,516
lcl|NC_002695.2_cds_NP_311577.1_3327,379,373,374,431,1557
lcl|NC_002695.2_cds_NP_311578.1_3328,84,132,91,122,429
lcl|NC_002695.2_cds_NP_311579.1_3329,124,140,132,171,567
lcl|NC_002695.2_cds_NP_311580.1_3330,49,45,40,52,186
lcl|NC_002695.2_cds_NP_311581.1_3331,629,592,636,774,2631
lcl|NC_002695.2_cds_NP_311582.1_3332,127,115,119,140,501
lcl|NC_002695.2_cds_NP_311583.1_3333,281,209,259,313,1062
lcl|NC_002695.2_cds_NP_311584.1_3334,110,108,119,161,498
lcl|NC_002695.2_cds_NP_311585.2_3335,271,271,310,339,1191
lcl|NC_002695.2_cds_NP_311587.1_3336,78,87,105,102,372
lcl|NC_002695.2_cds_NP_311588.1_3337,175,197,182,226,780
lcl|NC_002695.2_cds_NP_311589.1_3338,75,87,105,93,360
lcl|NC_002695.2_cds_NP_311590.1_3339,216,185,180,193,774
lcl|NC_002695.2_cds_NP_311591.2_3340,217,197,261,291,966
lcl|NC_002695.2_cds_NP_311592.2_3341,299,346,368,502,1515
lcl|NC_002695.2_cds_NP_311593.1_3342,323,253,325,335,1236
lcl|NC_002695.2_cds_NP_311594.1_3343,268,250,281,335,1134
lcl|NC_002695.2_cds_NP_311595.1_3344,440,515,592,706,2253
lcl|NC_002695.2_cds_NP_311596.1_3345,123,127,125,153,528
lcl|NC_002695.2_cds_NP_311597.3_3346,249,232,241,292,1014
lcl|NC_002695.2_cds_NP_311598.1_3347,290,345,392,431,1458
lcl|NC_002695.2_cds_NP_311599.1_3348,346,334,338,407,1425
lcl|NC_002695.2_cds_NP_311600.1_3349,114,101,113,143,471
lcl|NC_002695.2_cds_NP_311601.1_3350,104,90,93,124,411
lcl|NC_002695.2_cds_NP_311602.1_3351,160,170,208,230,768
lcl|NC_002695.2_cds_NP_311603.1_3352,132,106,158,147,543
lcl|NC_002695.2_cds_NP_311604.1_3353,370,375,469,496,1710
lcl|NC_002695.2_cds_NP_311605.1_3354,136,252,249,287,924
lcl|NC_002695.2_cds_NP_311606.1_3355,297,472,483,575,1827
lcl|NC_002695.2_cds_NP_311607.1_3356,127,138,176,171,612
lcl|NC_002695.2_cds_NP_311608.1_3357,133,98,115,116,462
lcl|NC_002695.2_cds_NP_311609.1_3358,90,76,86,99,351
lcl|NC_002695.2_cds_NP_311610.1_3359,216,175,248,234,873
lcl|NC_002695.2_cds_NP_311611.1_3360,64,58,67,84,273
lcl|NC_002695.2_cds_NP_311612.1_3361,229,264,300,329,1122
lcl|NC_002695.2_cds_NP_311613.2_3362,213,215,271,312,1011
lcl|NC_002695.2_cds_NP_311614.1_3363,514,480,534,551,2079
lcl|NC_002695.2_cds_NP_311615.1_3364,99,76,80,99,354
lcl|NC_002695.2_cds_NP_311616.1_3365,581,534,691,756,2562
lcl|NC_002695.2_cds_NP_311617.1_3366,191,188,140,138,657
lcl|NC_002695.2_cds_NP_311618.1_3367,58,49,62,68,237
lcl|NC_002695.2_cds_NP_311619.1_3368,314,291,408,415,1428
lcl|NC_002695.2_cds_NP_311620.1_3369,125,130,165,174,594
lcl|NC_002695.2_cds_NP_311621.1_3370,110,87,87,124,408
lcl|NC_002695.2_cds_NP_311622.1_3371,256,223,222,292,993
lcl|NC_002695.2_cds_NP_311623.1_3372,313,226,311,290,1140
lcl|NC_002695.2_cds_NP_311624.1_3373,143,145,144,195,627
lcl|NC_002695.2_cds_NP_311625.1_3374,157,188,193,224,762
lcl|NC_002695.2_cds_NP_311626.1_3375,261,245,234,310,1050
lcl|NC_002695.2_cds_NP_311627.1_3376,111,112,115,142,480
lcl|NC_002695.2_cds_NP_311628.1_3377,154,164,195,198,711
lcl|NC_002695.2_cds_NP_311629.1_3378,82,68,74,88,312
lcl|NC_002695.2_cds_NP_311630.1_3379,68,102,72,82,324
lcl|NC_002695.2_cds_NP_311631.1_3380,148,141,142,175,606
lcl|NC_002695.2_cds_NP_311632.1_3381,329,326,364,409,1428
lcl|NC_002695.2_cds_NP_311633.1_3382,221,200,227,261,909
lcl|NC_002695.2_cds_NP_311634.1_3383,296,234,235,273,1038
lcl|NC_002695.2_cds_NP_311635.1_3384,65,85,55,89,294
lcl|NC_002695.2_cds_NP_311636.1_3385,226,217,226,255,924
lcl|NC_002695.2_cds_NP_311637.3_3386,147,142,159,203,651
lcl|NC_002695.2_cds_NP_311638.1_3387,165,170,200,212,747
lcl|NC_002695.2_cds_NP_311639.1_3388,283,233,262,278,1056
lcl|NC_002695.2_cds_NP_311640.1_3389,140,122,125,150,537
lcl|NC_002695.2_cds_NP_311641.1_3390,398,376,360,429,1563
lcl|NC_002695.2_cds_NP_311642.2_3391,654,687,632,727,2700
lcl|NC_002695.2_cds_NP_311643.1_3392,41,44,25,43,153
lcl|NC_002695.2_cds_NP_311644.1_3393,206,154,177,198,735
lcl|NC_002695.2_cds_NP_311645.1_3394,424,328,454,507,1713
lcl|NC_002695.2_cds_NP_311646.1_3395,408,373,498,521,1800
lcl|NC_002695.2_cds_NP_311647.1_3396,95,93,87,91,366
lcl|NC_002695.2_cds_NP_311648.2_3397,261,315,326,370,1272
lcl|NC_002695.2_cds_NP_311649.2_3398,47,70,74,70,261
lcl|NC_002695.2_cds_NP_311650.1_3399,150,156,122,148,576
lcl|NC_002695.2_cds_NP_311653.2_3400,176,168,185,251,780
lcl|NC_002695.2_cds_NP_311656.1_3401,387,327,363,378,1455
lcl|NC_002695.2_cds_NP_311657.2_3402,210,214,165,197,786
lcl|NC_002695.2_cds_NP_311658.1_3403,283,360,319,316,1278
lcl|NC_002695.2_cds_NP_311659.1_3404,379,369,316,415,1479
lcl|NC_002695.2_cds_NP_311660.1_3405,168,158,157,189,672
lcl|NC_002695.2_cds_NP_311662.1_3406,188,177,143,167,675
lcl|NC_002695.2_cds_NP_311664.1_3407,295,322,252,280,1149
lcl|NC_002695.2_cds_NP_311665.3_3408,218,257,200,240,915
lcl|NC_002695.2_cds_NP_311666.1_3409,355,285,326,333,1299
lcl|NC_002695.2_cds_NP_311667.1_3410,398,389,409,442,1638
lcl|NC_002695.2_cds_NP_311668.1_3411,209,176,180,227,792
lcl|NC_002695.2_cds_NP_311669.1_3412,97,80,67,92,336
lcl|NC_002695.2_cds_NP_311670.1_3413,74,54,50,71,249
lcl|NC_002695.2_cds_NP_311671.1_3414,543,492,546,654,2235
lcl|NC_002695.2_cds_NP_311672.2_3415,332,301,318,351,1302
lcl|NC_002695.2_cds_NP_311673.1_3416,713,672,674,698,2757
lcl|NC_002695.2_cds_NP_311674.1_3417,316,308,316,401,1341
lcl|NC_002695.2_cds_NP_311676.1_3418,257,392,305,399,1353
lcl|NC_002695.2_cds_NP_311677.1_3419,109,105,100,136,450
lcl|NC_002695.2_cds_NP_311678.1_3420,184,178,192,229,783
lcl|NC_002695.2_cds_NP_311679.1_3421,78,80,87,85,330
lcl|NC_002695.2_cds_NP_311680.1_3422,150,135,127,134,546
lcl|NC_002695.2_cds_NP_311681.1_3423,220,211,208,210,849
lcl|NC_002695.2_cds_NP_311682.1_3424,322,345,345,353,1365
lcl|NC_002695.2_cds_NP_311683.1_3425,281,336,345,328,1290
lcl|NC_002695.2_cds_NP_311684.1_3426,309,316,343,400,1368
lcl|NC_002695.2_cds_NP_311685.3_3427,199,203,217,227,846
lcl|NC_002695.2_cds_NP_311686.2_3428,262,271,258,358,1149
lcl|NC_002695.2_cds_NP_311687.1_3429,168,159,149,172,648
lcl|NC_002695.2_cds_NP_311688.1_3430,306,387,334,290,1317
lcl|NC_002695.2_cds_NP_311689.1_3431,426,379,483,488,1776
lcl|NC_002695.2_cds_NP_311690.2_3432,348,346,343,382,1419
lcl|NC_002695.2_cds_NP_311691.1_3433,106,110,99,108,423
lcl|NC_002695.2_cds_NP_311692.1_3434,206,175,180,171,732
lcl|NC_002695.2_cds_NP_311693.1_3435,255,268,248,330,1101
lcl|NC_002695.2_cds_NP_311694.1_3436,64,117,92,123,396
lcl|NC_002695.2_cds_NP_311695.1_3437,229,239,214,236,918
lcl|NC_002695.2_cds_NP_311696.2_3438,69,52,55,52,228
lcl|NC_002695.2_cds_NP_311697.1_3439,258,272,318,358,1206
lcl|NC_002695.2_cds_NP_311698.1_3440,111,89,111,133,444
lcl|NC_002695.2_cds_NP_311699.1_3441,175,193,168,271,807
lcl|NC_002695.2_cds_NP_311700.1_3442,256,263,267,312,1098
lcl|NC_002695.2_cds_NP_311701.2_3443,316,266,310,362,1254
lcl|NC_002695.2_cds_NP_311702.1_3444,321,306,325,380,1332
lcl|NC_002695.2_cds_NP_311703.1_3445,401,419,448,559,1827
lcl|NC_002695.2_cds_NP_311704.1_3446,807,805,909,1022,3543
lcl|NC_002695.2_cds_NP_311705.1_3447,757,665,690,777,2889
lcl|NC_002695.2_cds_NP_311706.1_3448,751,803,860,955,3369
lcl|NC_002695.2_cds_NP_311707.1_3449,78,71,82,93,324
lcl|NC_002695.2_cds_NP_311708.2_3450,79,111,91,127,408
lcl|NC_002695.2_cds_NP_311709.1_3451,131,142,116,175,564
lcl|NC_002695.2_cds_NP_311710.1_3452,105,114,112,140,471
lcl|NC_002695.2_cds_NP_311711.1_3453,204,188,207,196,795
lcl|NC_002695.2_cds_NP_311712.1_3454,150,261,231,234,876
lcl|NC_002695.2_cds_NP_311713.1_3455,515,522,557,653,2247
lcl|NC_002695.2_cds_NP_311714.1_3456,148,121,111,151,531
lcl|NC_002695.2_cds_YP_009502650.1_3457,40,45,30,32,147
lcl|NC_002695.2_cds_NP_311715.1_3458,167,153,169,201,690
lcl|NC_002695.2_cds_NP_311716.1_3459,142,208,179,185,714
lcl|NC_002695.2_cds_NP_311717.1_3460,64,60,37,58,219
lcl|NC_002695.2_cds_NP_311718.1_3461,257,220,287,277,1041
lcl|NC_002695.2_cds_NP_311719.1_3462,212,318,288,376,1194
lcl|NC_002695.2_cds_NP_311720.1_3463,502,531,537,590,2160
lcl|NC_002695.2_cds_NP_311721.1_3464,228,259,264,281,1032
lcl|NC_002695.2_cds_NP_311722.1_3465,278,318,303,364,1263
lcl|NC_002695.2_cds_NP_311723.1_3466,203,234,252,247,936
lcl|NC_002695.2_cds_NP_311724.1_3467,160,182,147,204,693
lcl|NC_002695.2_cds_NP_311725.1_3468,292,400,316,411,1419
lcl|NC_002695.2_cds_NP_311726.1_3469,175,189,171,227,762
lcl|NC_002695.2_cds_NP_311727.1_3470,212,208,192,225,837
lcl|NC_002695.2_cds_NP_311728.2_3471,262,289,270,361,1182
lcl|NC_002695.2_cds_NP_311729.1_3472,292,392,277,269,1230
lcl|NC_002695.2_cds_NP_311730.2_3473,196,201,104,132,633
lcl|NC_002695.2_cds_NP_311731.1_3474,266,222,160,162,810
lcl|NC_002695.2_cds_NP_311732.1_3475,182,146,66,86,480
lcl|NC_002695.2_cds_NP_311733.2_3476,145,138,65,78,426
lcl|NC_002695.2_cds_NP_311734.1_3477,203,132,84,73,492
lcl|NC_002695.2_cds_NP_311735.1_3478,185,145,74,88,492
lcl|NC_002695.2_cds_NP_311736.1_3479,500,401,238,238,1377
lcl|NC_002695.2_cds_NP_311737.1_3480,81,66,38,34,219
lcl|NC_002695.2_cds_NP_311739.1_3481,219,183,95,136,633
lcl|NC_002695.2_cds_NP_311740.1_3482,143,149,64,76,432
lcl|NC_002695.2_cds_NP_311741.1_3483,105,76,30,50,261
lcl|NC_002695.2_cds_NP_311742.1_3484,188,194,107,93,582
lcl|NC_002695.2_cds_NP_311743.1_3485,234,233,122,146,735
lcl|NC_002695.2_cds_NP_311744.1_3486,112,92,60,69,333
lcl|NC_002695.2_cds_NP_311745.1_3487,82,64,45,49,240
lcl|NC_002695.2_cds_NP_311746.1_3488,267,226,110,132,735
lcl|NC_002695.2_cds_NP_311747.1_3489,171,162,90,78,501
lcl|NC_002695.2_cds_NP_311748.1_3490,393,358,163,208,1122
lcl|NC_002695.2_cds_NP_306455.1_3491,59,78,51,49,237
lcl|NC_002695.2_cds_NP_306456.1_3492,114,156,90,93,453
lcl|NC_002695.2_cds_NP_311751.1_3493,65,96,30,70,261
lcl|NC_002695.2_cds_NP_311752.1_3494,197,239,96,134,666
lcl|NC_002695.2_cds_NP_311753.1_3495,338,297,131,221,987
lcl|NC_002695.2_cds_NP_311754.2_3496,232,121,105,112,570
lcl|NC_002695.2_cds_NP_311755.1_3497,91,60,40,43,234
lcl|NC_002695.2_cds_NP_311756.2_3498,190,98,75,96,459
lcl|NC_002695.2_cds_NP_311757.2_3499,378,339,245,331,1293
lcl|NC_002695.2_cds_NP_311758.1_3500,589,702,326,444,2061
lcl|NC_002695.2_cds_NP_311759.1_3501,411,318,183,234,1146
lcl|NC_002695.2_cds_NP_311760.1_3502,564,479,290,371,1704
lcl|NC_002695.2_cds_NP_311761.1_3503,236,225,125,164,750
lcl|NC_002695.2_cds_NP_311762.1_3504,51,64,34,31,180
lcl|NC_002695.2_cds_NP_311763.1_3505,369,272,194,224,1059
lcl|NC_002695.2_cds_NP_311764.2_3506,182,142,113,127,564
lcl|NC_002695.2_cds_NP_311765.2_3507,202,166,182,206,756
lcl|NC_002695.2_cds_NP_311766.2_3508,563,518,600,617,2298
lcl|NC_002695.2_cds_NP_311767.1_3509,206,204,254,215,879
lcl|NC_002695.2_cds_NP_311768.1_3510,126,104,112,138,480
lcl|NC_002695.2_cds_NP_311769.1_3511,479,485,377,438,1779
lcl|NC_002695.2_cds_NP_311770.2_3512,339,259,303,287,1188
lcl|NC_002695.2_cds_NP_311771.1_3513,302,254,323,318,1197
lcl|NC_002695.2_cds_NP_311772.1_3514,306,279,305,322,1212
lcl|NC_002695.2_cds_NP_311773.2_3515,320,329,374,363,1386
lcl|NC_002695.2_cds_NP_311774.1_3516,249,224,202,258,933
lcl|NC_002695.2_cds_NP_311775.1_3517,367,406,356,497,1626
lcl|NC_002695.2_cds_NP_311776.2_3518,183,201,182,205,771
lcl|NC_002695.2_cds_NP_311777.1_3519,183,146,136,114,579
lcl|NC_002695.2_cds_NP_311778.1_3520,781,704,837,777,3099
lcl|NC_002695.2_cds_NP_311779.1_3521,317,313,342,357,1329
lcl|NC_002695.2_cds_NP_311780.1_3522,182,174,207,217,780
lcl|NC_002695.2_cds_NP_311781.1_3523,700,651,744,776,2871
lcl|NC_002695.2_cds_NP_311782.2_3524,279,437,335,350,1401
lcl|NC_002695.2_cds_NP_311783.2_3525,348,325,312,332,1317
lcl|NC_002695.2_cds_NP_311784.1_3526,257,388,334,389,1368
lcl|NC_002695.2_cds_NP_311786.2_3527,440,466,460,554,1920
lcl|NC_002695.2_cds_NP_311787.2_3528,298,440,345,366,1449
lcl|NC_002695.2_cds_YP_009502651.1_3529,27,55,24,20,126
lcl|NC_002695.2_cds_NP_311788.1_3530,141,131,131,146,549
lcl|NC_002695.2_cds_NP_311789.1_3531,376,347,393,402,1518
lcl|NC_002695.2_cds_NP_311790.1_3532,284,226,272,316,1098
lcl|NC_002695.2_cds_NP_311791.1_3533,358,388,450,538,1734
lcl|NC_002695.2_cds_NP_311792.1_3534,205,163,158,185,711
lcl|NC_002695.2_cds_NP_311793.1_3535,208,214,216,259,897
lcl|NC_002695.2_cds_NP_311794.1_3536,134,115,125,148,522
lcl|NC_002695.2_cds_NP_311795.1_3537,78,110,89,131,408
lcl|NC_002695.2_cds_NP_311796.1_3538,73,64,63,67,267
lcl|NC_002695.2_cds_NP_311797.1_3539,239,210,242,290,981
lcl|NC_002695.2_cds_NP_311798.1_3540,125,189,156,190,660
lcl|NC_002695.2_cds_NP_311799.1_3541,91,79,73,69,312
lcl|NC_002695.2_cds_NP_311800.2_3542,375,332,339,388,1434
lcl|NC_002695.2_cds_NP_311801.1_3543,657,615,788,814,2874
lcl|NC_002695.2_cds_NP_311802.1_3544,114,72,87,117,390
lcl|NC_002695.2_cds_NP_311803.1_3545,250,248,280,317,1095
lcl|NC_002695.2_cds_NP_311804.1_3546,257,284,303,359,1203
lcl|NC_002695.2_cds_NP_311805.1_3547,221,256,321,381,1179
lcl|NC_002695.2_cds_NP_311806.1_3548,333,287,341,365,1326
lcl|NC_002695.2_cds_NP_311807.3_3549,150,135,142,152,579
lcl|NC_002695.2_cds_NP_311808.1_3550,106,69,77,78,330
lcl|NC_002695.2_cds_NP_311809.4_3551,146,146,155,156,603
lcl|NC_002695.2_cds_NP_311811.1_3552,302,280,308,343,1233
lcl|NC_002695.2_cds_NP_311812.1_3553,167,150,157,186,660
lcl|NC_002695.2_cds_NP_311813.1_3554,206,203,244,241,894
lcl|NC_002695.2_cds_NP_311814.1_3555,512,459,608,566,2145
lcl|NC_002695.2_cds_NP_311815.1_3556,243,218,252,283,996
lcl|NC_002695.2_cds_NP_311816.2_3557,198,201,201,186,786
lcl|NC_002695.2_cds_NP_311817.1_3558,354,339,390,396,1479
lcl|NC_002695.2_cds_NP_311820.1_3559,195,158,182,206,741
lcl|NC_002695.2_cds_NP_311821.1_3560,118,196,141,181,636
lcl|NC_002695.2_cds_NP_311822.1_3561,194,238,198,231,861
lcl|NC_002695.2_cds_NP_311823.1_3562,285,244,280,271,1080
lcl|NC_002695.2_cds_NP_311824.1_3563,285,268,301,310,1164
lcl|NC_002695.2_cds_NP_311825.1_3564,242,251,261,266,1020
lcl|NC_002695.2_cds_NP_311826.1_3565,87,107,131,107,432
lcl|NC_002695.2_cds_NP_311827.1_3566,97,151,159,172,579
lcl|NC_002695.2_cds_NP_311828.1_3567,130,181,192,205,708
lcl|NC_002695.2_cds_NP_311829.1_3568,149,159,195,175,678
lcl|NC_002695.2_cds_NP_311830.1_3569,166,151,175,186,678
lcl|NC_002695.2_cds_NP_311831.1_3570,171,163,173,207,714
lcl|NC_002695.2_cds_NP_311832.1_3571,132,131,112,135,510
lcl|NC_002695.2_cds_NP_311833.1_3572,214,210,220,322,966
lcl|NC_002695.2_cds_NP_311834.1_3573,311,315,291,361,1278
lcl|NC_002695.2_cds_NP_311835.1_3574,307,388,304,390,1389
lcl|NC_002695.2_cds_NP_311836.1_3575,136,119,96,93,444
lcl|NC_002695.2_cds_NP_311837.1_3576,452,425,554,561,1992
lcl|NC_002695.2_cds_NP_311838.2_3577,207,160,176,216,759
lcl|NC_002695.2_cds_NP_311839.1_3578,194,219,237,271,921
lcl|NC_002695.2_cds_NP_311840.1_3579,184,191,166,191,732
lcl|NC_002695.2_cds_NP_311841.1_3580,446,459,505,567,1977
lcl|NC_002695.2_cds_NP_311842.2_3581,38,40,23,31,132
lcl|NC_002695.2_cds_NP_311843.1_3582,67,45,50,54,216
lcl|NC_002695.2_cds_NP_311844.1_3583,57,86,51,58,252
lcl|NC_002695.2_cds_NP_311845.1_3584,276,264,311,304,1155
lcl|NC_002695.2_cds_NP_311846.1_3585,290,365,361,379,1395
lcl|NC_002695.2_cds_NP_311847.2_3586,115,97,124,120,456
lcl|NC_002695.2_cds_NP_311848.1_3587,179,141,182,206,708
lcl|NC_002695.2_cds_NP_311849.2_3588,177,167,188,200,732
lcl|NC_002695.2_cds_NP_311850.1_3589,242,202,242,262,948
lcl|NC_002695.2_cds_NP_311851.3_3590,156,156,169,155,636
lcl|NC_002695.2_cds_NP_311852.1_3591,103,94,110,110,417
lcl|NC_002695.2_cds_NP_311854.2_3592,223,217,226,315,981
lcl|NC_002695.2_cds_NP_311853.3_3593,183,161,175,186,705
lcl|NC_002695.2_cds_NP_311855.1_3594,107,168,137,155,567
lcl|NC_002695.2_cds_NP_311856.2_3595,81,67,69,74,291
lcl|NC_002695.2_cds_NP_311857.1_3596,136,126,162,170,594
lcl|NC_002695.2_cds_NP_311858.1_3597,256,276,279,326,1137
lcl|NC_002695.2_cds_NP_311859.1_3598,336,226,192,254,1008
lcl|NC_002695.2_cds_NP_311860.1_3599,273,221,277,276,1047
lcl|NC_002695.2_cds_NP_311861.1_3600,208,133,167,212,720
lcl|NC_002695.2_cds_NP_311862.2_3601,95,72,66,94,327
lcl|NC_002695.2_cds_NP_311863.1_3602,167,172,167,214,720
lcl|NC_002695.2_cds_NP_311864.1_3603,228,241,281,303,1053
lcl|NC_002695.2_cds_NP_311865.1_3604,92,54,58,72,276
lcl|NC_002695.2_cds_NP_311866.2_3605,273,253,283,271,1080
lcl|NC_002695.2_cds_NP_311867.2_3606,260,370,314,313,1257
lcl|NC_002695.2_cds_NP_311868.2_3607,468,558,499,611,2136
lcl|NC_002695.2_cds_NP_311869.1_3608,144,199,180,185,708
lcl|NC_002695.2_cds_NP_311870.1_3609,354,310,305,297,1266
lcl|NC_002695.2_cds_NP_311873.1_3610,189,158,170,158,675
lcl|NC_002695.2_cds_NP_311874.1_3611,81,69,95,103,348
lcl|NC_002695.2_cds_NP_311877.2_3612,149,172,71,142,534
lcl|NC_002695.2_cds_NP_311882.1_3613,618,514,224,294,1650
lcl|NC_002695.2_cds_NP_311884.1_3614,345,299,150,196,990
lcl|NC_002695.2_cds_NP_311885.1_3615,250,195,100,130,675
lcl|NC_002695.2_cds_NP_311889.2_3616,219,189,209,271,888
lcl|NC_002695.2_cds_NP_311890.1_3617,75,75,79,98,327
lcl|NC_002695.2_cds_NP_311892.2_3618,69,75,99,105,348
lcl|NC_002695.2_cds_NP_311893.2_3619,345,294,425,475,1539
lcl|NC_002695.2_cds_NP_311895.1_3620,77,90,95,89,351
lcl|NC_002695.2_cds_NP_311896.1_3621,355,274,360,415,1404
lcl|NC_002695.2_cds_NP_311900.1_3622,457,427,449,527,1860
lcl|NC_002695.2_cds_NP_311901.2_3623,202,195,208,262,867
lcl|NC_002695.2_cds_NP_311902.1_3624,59,58,58,74,249
lcl|NC_002695.2_cds_NP_311903.1_3625,68,82,82,110,342
lcl|NC_002695.2_cds_NP_311904.1_3626,101,121,130,137,489
lcl|NC_002695.2_cds_NP_311905.1_3627,106,117,120,152,495
lcl|NC_002695.2_cds_NP_311906.1_3628,408,385,439,472,1704
lcl|NC_002695.2_cds_NP_311907.1_3629,200,338,300,341,1179
lcl|NC_002695.2_cds_NP_311908.1_3630,244,205,256,282,987
lcl|NC_002695.2_cds_NP_311909.1_3631,262,247,295,315,1119
lcl|NC_002695.2_cds_NP_311910.1_3632,77,80,55,76,288
lcl|NC_002695.2_cds_NP_311911.3_3633,218,211,210,249,888
lcl|NC_002695.2_cds_NP_311912.1_3634,257,242,256,286,1041
lcl|NC_002695.2_cds_NP_311913.1_3635,108,155,107,125,495
lcl|NC_002695.2_cds_NP_311914.1_3636,228,177,227,253,885
lcl|NC_002695.2_cds_NP_311916.1_3637,119,94,98,115,426
lcl|NC_002695.2_cds_NP_311917.1_3638,164,179,175,217,735
lcl|NC_002695.2_cds_NP_311919.1_3639,285,289,285,329,1188
lcl|NC_002695.2_cds_NP_311920.1_3640,128,195,162,175,660
lcl|NC_002695.2_cds_NP_311922.2_3641,245,232,217,263,957
lcl|NC_002695.2_cds_NP_311921.3_3642,284,243,318,319,1164
lcl|NC_002695.2_cds_NP_311923.2_3643,238,169,219,202,828
lcl|NC_002695.2_cds_NP_311926.1_3644,74,59,62,63,258
lcl|NC_002695.2_cds_NP_311927.1_3645,510,500,598,612,2220
lcl|NC_002695.2_cds_NP_311928.1_3646,289,327,377,420,1413
lcl|NC_002695.2_cds_NP_311929.1_3647,184,188,185,181,738
lcl|NC_002695.2_cds_NP_311930.1_3648,535,489,569,666,2259
lcl|NC_002695.2_cds_NP_311931.1_3649,404,362,407,435,1608
lcl|NC_002695.2_cds_NP_311932.1_3650,112,116,123,132,483
lcl|NC_002695.2_cds_NP_311933.1_3651,113,76,93,111,393
lcl|NC_002695.2_cds_NP_311934.1_3652,169,149,150,192,660
lcl|NC_002695.2_cds_NP_306641.1_3653,331,308,343,368,1350
lcl|NC_002695.2_cds_NP_311937.1_3654,156,132,144,150,582
lcl|NC_002695.2_cds_NP_311938.1_3655,81,76,72,86,315
lcl|NC_002695.2_cds_NP_311939.1_3656,213,213,204,258,888
lcl|NC_002695.2_cds_NP_311940.1_3657,224,249,223,252,948
lcl|NC_002695.2_cds_NP_311941.2_3658,180,335,222,301,1038
lcl|NC_002695.2_cds_NP_311942.1_3659,158,296,244,286,984
lcl|NC_002695.2_cds_NP_311943.1_3660,194,219,172,225,810
lcl|NC_002695.2_cds_NP_311944.1_3661,585,526,521,510,2142
lcl|NC_002695.2_cds_NP_311945.1_3662,447,425,460,561,1893
lcl|NC_002695.2_cds_NP_311946.1_3663,124,144,157,157,582
lcl|NC_002695.2_cds_NP_311947.1_3664,171,193,229,235,828
lcl|NC_002695.2_cds_NP_311948.1_3665,112,106,99,106,423
lcl|NC_002695.2_cds_NP_311949.1_3666,167,147,132,184,630
lcl|NC_002695.2_cds_NP_311950.2_3667,394,322,401,365,1482
lcl|NC_002695.2_cds_NP_311952.2_3668,172,123,195,182,672
lcl|NC_002695.2_cds_NP_311953.1_3669,299,276,277,309,1161
lcl|NC_002695.2_cds_NP_311954.3_3670,179,201,187,249,816
lcl|NC_002695.2_cds_NP_311955.1_3671,156,207,187,224,774
lcl|NC_002695.2_cds_YP_009502652.1_3672,48,48,28,47,171
lcl|NC_002695.2_cds_NP_311956.1_3673,153,157,160,184,654
lcl|NC_002695.2_cds_NP_311957.3_3674,93,58,72,77,300
lcl|NC_002695.2_cds_NP_311958.1_3675,58,57,40,46,201
lcl|NC_002695.2_cds_NP_311959.1_3676,153,202,142,118,615
lcl|NC_002695.2_cds_NP_311960.1_3677,476,343,403,440,1662
lcl|NC_002695.2_cds_NP_311962.1_3678,326,309,352,447,1434
lcl|NC_002695.2_cds_NP_311963.1_3679,619,630,713,879,2841
lcl|NC_002695.2_cds_NP_311964.1_3680,309,275,331,387,1302
lcl|NC_002695.2_cds_NP_311965.1_3681,176,118,167,160,621
lcl|NC_002695.2_cds_NP_311966.1_3682,268,273,333,365,1239
lcl|NC_002695.2_cds_NP_311967.1_3683,145,245,179,253,822
lcl|NC_002695.2_cds_NP_311968.2_3684,100,82,73,114,369
lcl|NC_002695.2_cds_NP_311969.1_3685,125,161,161,171,618
lcl|NC_002695.2_cds_NP_311970.1_3686,242,228,203,260,933
lcl|NC_002695.2_cds_NP_311971.1_3687,228,190,245,249,912
lcl|NC_002695.2_cds_NP_311972.1_3688,160,121,155,170,606
lcl|NC_002695.2_cds_NP_311973.1_3689,249,404,385,426,1464
lcl|NC_002695.2_cds_NP_311974.1_3690,201,232,257,324,1014
lcl|NC_002695.2_cds_NP_311975.1_3691,59,45,55,57,216
lcl|NC_002695.2_cds_NP_311976.1_3692,435,399,444,468,1746
lcl|NC_002695.2_cds_NP_311977.1_3693,500,367,474,501,1842
lcl|NC_002695.2_cds_NP_311978.1_3694,122,118,112,155,507
lcl|NC_002695.2_cds_NP_311979.1_3695,162,170,208,225,765
lcl|NC_002695.2_cds_NP_311980.1_3696,168,125,148,183,624
lcl|NC_002695.2_cds_NP_311981.2_3697,361,317,373,470,1521
lcl|NC_002695.2_cds_NP_311982.4_3698,349,326,386,430,1491
lcl|NC_002695.2_cds_NP_311983.1_3699,95,68,64,106,333
lcl|NC_002695.2_cds_NP_311984.1_3700,258,220,256,250,984
lcl|NC_002695.2_cds_NP_311985.2_3701,733,682,854,824,3093
lcl|NC_002695.2_cds_NP_311986.1_3702,139,108,97,106,450
lcl|NC_002695.2_cds_NP_311987.1_3703,298,429,362,345,1434
lcl|NC_002695.2_cds_NP_311988.1_3704,269,246,284,272,1071
lcl|NC_002695.2_cds_NP_311989.1_3705,594,475,613,670,2352
lcl|NC_002695.2_cds_NP_311990.1_3706,461,401,545,612,2019
lcl|NC_002695.2_cds_NP_311991.1_3707,109,108,95,105,417
lcl|NC_002695.2_cds_NP_311992.1_3708,108,88,52,67,315
lcl|NC_002695.2_cds_NP_311993.2_3709,274,246,311,306,1137
lcl|NC_002695.2_cds_NP_311994.2_3710,136,111,131,126,504
lcl|NC_002695.2_cds_NP_311995.1_3711,169,166,170,188,693
lcl|NC_002695.2_cds_NP_311996.2_3712,231,241,247,268,987
lcl|NC_002695.2_cds_NP_311997.1_3713,162,279,239,286,966
lcl|NC_002695.2_cds_NP_311998.1_3714,220,341,337,347,1245
lcl|NC_002695.2_cds_NP_311999.1_3715,113,163,126,150,552
lcl|NC_002695.2_cds_NP_312000.1_3716,366,318,378,426,1488
lcl|NC_002695.2_cds_NP_312001.1_3717,339,311,379,384,1413
lcl|NC_002695.2_cds_NP_312002.2_3718,250,342,317,390,1299
lcl|NC_002695.2_cds_NP_312003.2_3719,213,168,200,196,777
lcl|NC_002695.2_cds_NP_312004.1_3720,133,195,154,181,663
lcl|NC_002695.2_cds_NP_312005.1_3721,87,89,117,91,384
lcl|NC_002695.2_cds_NP_312006.2_3722,122,68,82,97,369
lcl|NC_002695.2_cds_NP_312007.1_3723,75,64,70,97,306
lcl|NC_002695.2_cds_NP_312008.1_3724,88,103,94,120,405
lcl|NC_002695.2_cds_NP_312009.1_3725,64,66,76,94,300
lcl|NC_002695.2_cds_NP_312010.1_3726,114,130,112,127,483
lcl|NC_002695.2_cds_NP_312011.1_3727,248,240,263,236,987
lcl|NC_002695.2_cds_NP_312012.1_3728,77,100,87,102,366
lcl|NC_002695.2_cds_NP_312013.1_3729,68,130,81,78,357
lcl|NC_002695.2_cds_NP_312014.1_3730,210,191,214,282,897
lcl|NC_002695.2_cds_NP_312015.1_3731,168,160,183,191,702
lcl|NC_002695.2_cds_NP_312016.2_3732,50,28,38,49,165
lcl|NC_002695.2_cds_NP_312017.1_3733,278,288,312,433,1311
lcl|NC_002695.2_cds_NP_312018.1_3734,272,391,294,375,1332
lcl|NC_002695.2_cds_NP_312019.1_3735,321,313,329,402,1365
lcl|NC_002695.2_cds_NP_312020.2_3736,99,89,97,105,390
lcl|NC_002695.2_cds_NP_312021.1_3737,562,513,599,621,2295
lcl|NC_002695.2_cds_NP_312022.2_3738,297,330,269,313,1209
lcl|NC_002695.2_cds_NP_312023.1_3739,269,401,337,325,1332
lcl|NC_002695.2_cds_NP_312024.1_3740,270,260,213,247,990
lcl|NC_002695.2_cds_NP_312025.1_3741,263,281,176,219,939
lcl|NC_002695.2_cds_NP_312026.1_3742,117,119,55,54,345
lcl|NC_002695.2_cds_NP_312027.2_3743,183,166,104,87,540
lcl|NC_002695.2_cds_NP_312028.1_3744,456,365,188,179,1188
lcl|NC_002695.2_cds_NP_312029.2_3745,273,257,259,357,1146
lcl|NC_002695.2_cds_NP_312030.2_3746,224,198,198,271,891
lcl|NC_002695.2_cds_NP_312031.1_3747,184,181,202,204,771
lcl|NC_002695.2_cds_NP_312032.1_3748,266,393,328,348,1335
lcl|NC_002695.2_cds_NP_312033.1_3749,392,344,385,451,1572
lcl|NC_002695.2_cds_NP_312034.1_3750,102,74,81,79,336
lcl|NC_002695.2_cds_NP_312035.1_3751,148,109,98,110,465
lcl|NC_002695.2_cds_NP_312036.1_3752,197,186,183,244,810
lcl|NC_002695.2_cds_NP_312037.1_3753,298,276,366,341,1281
lcl|NC_002695.2_cds_NP_312038.2_3754,119,112,110,133,474
lcl|NC_002695.2_cds_NP_312039.1_3755,145,200,217,218,780
lcl|NC_002695.2_cds_NP_312040.1_3756,191,234,215,239,879
lcl|NC_002695.2_cds_NP_312041.1_3757,103,100,95,137,435
lcl|NC_002695.2_cds_NP_312042.2_3758,238,241,286,369,1134
lcl|NC_002695.2_cds_NP_312043.1_3759,262,242,356,295,1155
lcl|NC_002695.2_cds_NP_312044.1_3760,215,195,215,236,861
lcl|NC_002695.2_cds_NP_312045.1_3761,140,125,104,108,477
lcl|NC_002695.2_cds_NP_312047.1_3762,159,157,130,139,585
lcl|NC_002695.2_cds_NP_312048.2_3763,208,169,148,150,675
lcl|NC_002695.2_cds_NP_312049.1_3764,709,614,616,578,2517
lcl|NC_002695.2_cds_NP_312051.1_3765,75,75,79,98,327
lcl|NC_002695.2_cds_NP_312052.2_3766,219,189,209,271,888
lcl|NC_002695.2_cds_NP_312054.1_3767,210,182,222,247,861
lcl|NC_002695.2_cds_NP_312055.1_3768,515,421,551,550,2037
lcl|NC_002695.2_cds_NP_312056.1_3769,93,87,97,119,396
lcl|NC_002695.2_cds_NP_312057.1_3770,146,145,146,154,591
lcl|NC_002695.2_cds_NP_312058.1_3771,143,119,137,177,576
lcl|NC_002695.2_cds_NP_312059.1_3772,171,271,249,350,1041
lcl|NC_002695.2_cds_NP_312060.2_3773,145,138,158,195,636
lcl|NC_002695.2_cds_NP_312061.2_3774,137,120,122,140,519
lcl|NC_002695.2_cds_NP_312062.1_3775,111,88,109,136,444
lcl|NC_002695.2_cds_NP_312063.1_3776,81,57,75,90,303
lcl|NC_002695.2_cds_NP_312064.1_3777,103,124,114,163,504
lcl|NC_002695.2_cds_NP_312065.1_3778,123,130,113,159,525
lcl|NC_002695.2_cds_NP_312066.1_3779,209,216,276,295,996
lcl|NC_002695.2_cds_NP_312067.2_3780,198,190,227,264,879
lcl|NC_002695.2_cds_NP_312068.1_3781,204,238,279,287,1008
lcl|NC_002695.2_cds_NP_312069.1_3782,229,360,302,354,1245
lcl|NC_002695.2_cds_NP_312070.2_3783,418,429,483,560,1890
lcl|NC_002695.2_cds_NP_312071.1_3784,234,224,199,228,885
lcl|NC_002695.2_cds_NP_312072.2_3785,505,480,542,609,2136
lcl|NC_002695.2_cds_NP_312073.1_3786,70,59,76,65,270
lcl|NC_002695.2_cds_NP_312074.1_3787,221,224,231,269,945
lcl|NC_002695.2_cds_NP_312075.1_3788,105,86,98,113,402
lcl|NC_002695.2_cds_NP_312076.1_3789,730,513,650,780,2673
lcl|NC_002695.2_cds_NP_312077.1_3790,386,314,355,433,1488
lcl|NC_002695.2_cds_NP_312078.3_3791,114,120,100,119,453
lcl|NC_002695.2_cds_NP_312079.1_3792,334,302,338,370,1344
lcl|NC_002695.2_cds_NP_312080.3_3793,408,452,322,336,1518
lcl|NC_002695.2_cds_NP_312081.1_3794,82,83,81,87,333
lcl|NC_002695.2_cds_NP_312082.1_3795,310,305,309,414,1338
lcl|NC_002695.2_cds_NP_312083.2_3796,208,203,204,234,849
lcl|NC_002695.2_cds_NP_312084.2_3797,462,439,476,567,1944
lcl|NC_002695.2_cds_NP_312085.1_3798,151,161,137,181,630
lcl|NC_002695.2_cds_NP_312086.1_3799,90,61,71,72,294
lcl|NC_002695.2_cds_NP_312087.2_3800,137,108,107,125,477
lcl|NC_002695.2_cds_NP_312088.1_3801,333,342,381,378,1434
lcl|NC_002695.2_cds_NP_312089.1_3802,297,256,249,371,1173
lcl|NC_002695.2_cds_NP_312090.1_3803,183,273,227,283,966
lcl|NC_002695.2_cds_NP_312091.1_3804,72,57,60,69,258
lcl|NC_002695.2_cds_NP_312092.1_3805,86,75,64,87,312
lcl|NC_002695.2_cds_NP_312093.1_3806,246,213,246,267,972
lcl|NC_002695.2_cds_NP_312094.1_3807,77,61,67,74,279
lcl|NC_002695.2_cds_NP_312095.1_3808,301,288,306,365,1260
lcl|NC_002695.2_cds_NP_312096.3_3809,67,68,59,76,270
lcl|NC_002695.2_cds_NP_312097.2_3810,68,69,65,92,294
lcl|NC_002695.2_cds_NP_312098.1_3811,169,134,163,170,636
lcl|NC_002695.2_cds_NP_312099.1_3812,143,134,122,153,552
lcl|NC_002695.2_cds_NP_312100.1_3813,131,220,180,252,783
lcl|NC_002695.2_cds_NP_312101.1_3814,161,206,197,246,810
lcl|NC_002695.2_cds_NP_312102.1_3815,184,285,241,268,978
lcl|NC_002695.2_cds_NP_312103.1_3816,225,247,239,276,987
lcl|NC_002695.2_cds_NP_312104.1_3817,135,137,129,166,567
lcl|NC_002695.2_cds_NP_312105.1_3818,177,131,137,131,576
lcl|NC_002695.2_cds_NP_312106.1_3819,171,113,139,135,558
lcl|NC_002695.2_cds_NP_312107.1_3820,171,162,194,199,726
lcl|NC_002695.2_cds_NP_312108.1_3821,377,299,384,374,1434
lcl|NC_002695.2_cds_NP_312109.1_3822,96,63,66,63,288
lcl|NC_002695.2_cds_NP_312110.1_3823,133,105,129,125,492
lcl|NC_002695.2_cds_NP_312111.1_3824,200,209,232,214,855
lcl|NC_002695.2_cds_NP_312112.1_3825,74,66,57,76,273
lcl|NC_002695.2_cds_NP_312113.1_3826,161,150,153,169,633
lcl|NC_002695.2_cds_NP_312114.1_3827,158,192,173,206,729
lcl|NC_002695.2_cds_NP_312115.2_3828,149,160,143,202,654
lcl|NC_002695.2_cds_NP_312116.1_3829,611,546,531,649,2337
lcl|NC_002695.2_cds_NP_312117.1_3830,201,213,236,280,930
lcl|NC_002695.2_cds_NP_312118.3_3831,1008,943,1300,1303,4554
lcl|NC_002695.2_cds_NP_312119.1_3832,345,289,360,425,1419
lcl|NC_002695.2_cds_NP_312120.1_3833,279,258,252,261,1050
lcl|NC_002695.2_cds_NP_312121.1_3834,135,109,95,126,465
lcl|NC_002695.2_cds_NP_312122.2_3835,170,192,234,280,876
lcl|NC_002695.2_cds_NP_312123.1_3836,150,140,185,215,690
lcl|NC_002695.2_cds_NP_312124.2_3837,274,404,387,426,1491
lcl|NC_002695.2_cds_NP_312125.1_3838,217,214,220,243,894
lcl|NC_002695.2_cds_NP_312126.3_3839,191,176,225,200,792
lcl|NC_002695.2_cds_NP_312127.1_3840,284,392,317,372,1365
lcl|NC_002695.2_cds_NP_312128.1_3841,109,114,130,145,498
lcl|NC_002695.2_cds_NP_312129.1_3842,142,155,167,175,639
lcl|NC_002695.2_cds_NP_312130.1_3843,93,96,100,104,393
lcl|NC_002695.2_cds_NP_312131.1_3844,121,91,110,107,429
lcl|NC_002695.2_cds_NP_312132.1_3845,273,271,267,317,1128
lcl|NC_002695.2_cds_NP_312133.2_3846,98,83,104,114,399
lcl|NC_002695.2_cds_NP_312134.1_3847,351,303,340,374,1368
lcl|NC_002695.2_cds_NP_312135.1_3848,248,257,277,286,1068
lcl|NC_002695.2_cds_NP_312136.1_3849,216,231,228,264,939
lcl|NC_002695.2_cds_NP_312137.1_3850,130,113,113,115,471
lcl|NC_002695.2_cds_NP_312138.2_3851,76,60,63,65,264
lcl|NC_002695.2_cds_NP_312139.1_3852,68,88,43,74,273
lcl|NC_002695.2_cds_NP_312140.1_3853,432,501,495,540,1968
lcl|NC_002695.2_cds_NP_312141.1_3854,227,202,240,261,930
lcl|NC_002695.2_cds_NP_312142.2_3855,28,80,46,50,204
lcl|NC_002695.2_cds_NP_312143.1_3856,224,215,229,262,930
lcl|NC_002695.2_cds_NP_312144.1_3857,327,328,344,447,1446
lcl|NC_002695.2_cds_NP_312145.1_3858,910,851,948,1092,3801
lcl|NC_002695.2_cds_NP_312146.1_3859,365,336,348,421,1470
lcl|NC_002695.2_cds_NP_312147.1_3860,139,134,132,189,594
lcl|NC_002695.2_cds_NP_312148.1_3861,85,154,109,141,489
lcl|NC_002695.2_cds_NP_312149.1_3862,229,258,293,324,1104
lcl|NC_002695.2_cds_NP_312150.2_3863,226,251,267,300,1044
lcl|NC_002695.2_cds_NP_312151.1_3864,467,492,459,523,1941
lcl|NC_002695.2_cds_NP_312152.1_3865,213,223,234,305,975
lcl|NC_002695.2_cds_NP_312154.1_3866,131,97,120,123,471
lcl|NC_002695.2_cds_NP_312155.1_3867,339,292,362,357,1350
lcl|NC_002695.2_cds_NP_312156.1_3868,37,72,60,74,243
lcl|NC_002695.2_cds_NP_312157.2_3869,267,401,372,412,1452
lcl|NC_002695.2_cds_NP_312158.1_3870,207,193,228,254,882
lcl|NC_002695.2_cds_NP_312159.1_3871,239,222,240,265,966
lcl|NC_002695.2_cds_NP_312160.1_3872,88,69,69,71,297
lcl|NC_002695.2_cds_NP_312161.2_3873,264,201,213,207,885
lcl|NC_002695.2_cds_NP_312162.1_3874,50,57,33,40,180
lcl|NC_002695.2_cds_NP_312163.1_3875,204,166,136,157,663
lcl|NC_002695.2_cds_NP_312164.1_3876,306,247,308,297,1158
lcl|NC_002695.2_cds_NP_312167.1_3877,46,55,53,68,222
lcl|NC_002695.2_cds_NP_312168.2_3878,271,247,232,276,1026
lcl|NC_002695.2_cds_NP_312169.2_3879,225,358,318,281,1182
lcl|NC_002695.2_cds_NP_312170.2_3880,220,311,261,312,1104
lcl|NC_002695.2_cds_NP_312171.1_3881,200,194,157,208,759
lcl|NC_002695.2_cds_NP_312172.2_3882,140,145,117,153,555
lcl|NC_002695.2_cds_NP_312173.1_3883,71,61,50,76,258
lcl|NC_002695.2_cds_NP_312174.1_3884,186,231,184,218,819
lcl|NC_002695.2_cds_NP_312175.1_3885,125,148,140,160,573
lcl|NC_002695.2_cds_NP_312176.2_3886,138,134,135,136,543
lcl|NC_002695.2_cds_NP_312177.1_3887,129,128,95,122,474
lcl|NC_002695.2_cds_NP_312178.1_3888,262,290,255,318,1125
lcl|NC_002695.2_cds_NP_312179.1_3889,147,125,104,134,510
lcl|NC_002695.2_cds_NP_312180.1_3890,229,221,243,255,948
lcl|NC_002695.2_cds_NP_312181.2_3891,333,314,322,321,1290
lcl|NC_002695.2_cds_NP_312182.1_3892,339,347,326,365,1377
lcl|NC_002695.2_cds_NP_312183.1_3893,111,115,82,103,411
lcl|NC_002695.2_cds_YP_009502653.1_3894,76,47,38,58,219
lcl|NC_002695.2_cds_NP_312184.1_3895,111,101,92,122,426
lcl|NC_002695.2_cds_NP_312185.1_3896,102,90,75,102,369
lcl|NC_002695.2_cds_NP_312186.1_3897,90,88,99,107,384
lcl|NC_002695.2_cds_NP_312187.1_3898,244,229,246,271,990
lcl|NC_002695.2_cds_NP_312188.1_3899,158,148,139,176,621
lcl|NC_002695.2_cds_NP_312189.1_3900,95,93,103,99,390
lcl|NC_002695.2_cds_NP_312190.1_3901,88,84,89,96,357
lcl|NC_002695.2_cds_NP_312191.1_3902,33,28,25,31,117
lcl|NC_002695.2_cds_NP_312192.1_3903,286,384,311,351,1332
lcl|NC_002695.2_cds_NP_312193.1_3904,96,105,102,132,435
lcl|NC_002695.2_cds_NP_312194.1_3905,46,44,43,47,180
lcl|NC_002695.2_cds_NP_312195.1_3906,131,122,115,136,504
lcl|NC_002695.2_cds_NP_312196.1_3907,85,79,95,95,354
lcl|NC_002695.2_cds_NP_312197.1_3908,125,131,126,152,534
lcl|NC_002695.2_cds_NP_312198.1_3909,102,94,90,107,393
lcl|NC_002695.2_cds_NP_312199.1_3910,77,68,77,84,306
lcl|NC_002695.2_cds_NP_312200.1_3911,141,130,137,132,540
lcl|NC_002695.2_cds_NP_312201.1_3912,98,71,67,79,315
lcl|NC_002695.2_cds_NP_312202.1_3913,93,89,87,103,372
lcl|NC_002695.2_cds_NP_312203.1_3914,73,61,57,64,255
lcl|NC_002695.2_cds_NP_312204.1_3915,52,36,44,60,192
lcl|NC_002695.2_cds_NP_312205.1_3916,107,92,91,121,411
lcl|NC_002695.2_cds_NP_312206.1_3917,189,155,171,187,702
lcl|NC_002695.2_cds_NP_312207.1_3918,88,79,82,84,333
lcl|NC_002695.2_cds_NP_312208.1_3919,77,65,68,69,279
lcl|NC_002695.2_cds_NP_312209.1_3920,202,183,213,224,822
lcl|NC_002695.2_cds_NP_312210.1_3921,94,63,66,80,303
lcl|NC_002695.2_cds_NP_312211.1_3922,145,140,146,175,606
lcl|NC_002695.2_cds_NP_312212.1_3923,163,144,148,175,630
lcl|NC_002695.2_cds_NP_312213.1_3924,74,65,90,83,312
lcl|NC_002695.2_cds_NP_312215.1_3925,87,157,105,119,468
lcl|NC_002695.2_cds_NP_312216.1_3926,151,127,87,112,477
lcl|NC_002695.2_cds_YP_009502654.1_3927,53,55,36,51,195
lcl|NC_002695.2_cds_NP_312217.1_3928,288,267,306,324,1185
lcl|NC_002695.2_cds_NP_312218.1_3929,552,490,513,560,2115
lcl|NC_002695.2_cds_NP_312219.1_3930,120,117,110,124,471
lcl|NC_002695.2_cds_NP_312220.1_3931,91,84,101,99,375
lcl|NC_002695.2_cds_NP_312221.1_3932,64,77,77,70,288
lcl|NC_002695.2_cds_NP_312222.1_3933,70,106,88,96,360
lcl|NC_002695.2_cds_NP_312223.1_3934,83,90,91,123,387
lcl|NC_002695.2_cds_NP_312224.2_3935,188,193,173,169,723
lcl|NC_002695.2_cds_NP_312225.1_3936,249,170,183,211,813
lcl|NC_002695.2_cds_NP_312226.1_3937,62,41,56,60,219
lcl|NC_002695.2_cds_NP_312227.1_3938,136,127,141,187,591
lcl|NC_002695.2_cds_YP_009502655.1_3939,59,43,41,58,201
lcl|NC_002695.2_cds_NP_312228.1_3940,326,482,399,572,1779
lcl|NC_002695.2_cds_NP_312229.2_3941,116,125,150,161,552
lcl|NC_002695.2_cds_NP_312230.1_3942,482,369,533,530,1914
lcl|NC_002695.2_cds_NP_312231.1_3943,226,243,275,279,1023
lcl|NC_002695.2_cds_NP_312232.1_3944,61,48,50,60,219
lcl|NC_002695.2_cds_NP_312233.1_3945,221,190,236,223,870
lcl|NC_002695.2_cds_NP_312234.1_3946,95,102,84,124,405
lcl|NC_002695.2_cds_NP_312235.1_3947,173,146,155,159,633
lcl|NC_002695.2_cds_NP_312236.3_3948,466,521,543,561,2091
lcl|NC_002695.2_cds_NP_312237.1_3949,262,297,288,374,1221
lcl|NC_002695.2_cds_NP_312238.1_3950,126,136,148,154,564
lcl|NC_002695.2_cds_NP_312239.1_3951,146,138,136,183,603
lcl|NC_002695.2_cds_NP_312240.1_3952,42,40,41,45,168
lcl|NC_002695.2_cds_NP_312241.1_3953,143,137,153,140,573
lcl|NC_002695.2_cds_NP_312242.1_3954,223,346,309,304,1182
lcl|NC_002695.2_cds_NP_312243.2_3955,611,548,680,705,2544
lcl|NC_002695.2_cds_NP_312244.1_3956,77,67,85,98,327
lcl|NC_002695.2_cds_NP_312245.2_3957,152,212,211,232,807
lcl|NC_002695.2_cds_NP_312246.1_3958,310,310,347,407,1374
lcl|NC_002695.2_cds_NP_312247.1_3959,48,50,36,34,168
lcl|NC_002695.2_cds_NP_312248.2_3960,247,356,391,344,1338
lcl|NC_002695.2_cds_NP_312249.2_3961,231,235,271,286,1023
lcl|NC_002695.2_cds_NP_312250.1_3962,198,175,206,249,828
lcl|NC_002695.2_cds_NP_312252.4_3963,194,162,198,178,732
lcl|NC_002695.2_cds_NP_312253.1_3964,254,222,251,278,1005
lcl|NC_002695.2_cds_NP_312254.1_3965,177,181,182,219,759
lcl|NC_002695.2_cds_NP_312255.1_3966,160,170,169,179,678
lcl|NC_002695.2_cds_NP_312256.1_3967,208,218,201,210,837
lcl|NC_002695.2_cds_NP_312257.1_3968,358,233,347,349,1287
lcl|NC_002695.2_cds_NP_312258.1_3969,221,279,263,326,1089
lcl|NC_002695.2_cds_NP_312259.3_3970,188,168,143,179,678
lcl|NC_002695.2_cds_NP_312260.2_3971,306,244,287,372,1209
lcl|NC_002695.2_cds_NP_312261.2_3972,114,80,84,127,405
lcl|NC_002695.2_cds_NP_312262.1_3973,93,114,118,116,441
lcl|NC_002695.2_cds_NP_312263.1_3974,130,115,148,147,540
lcl|NC_002695.2_cds_NP_312264.1_3975,157,182,207,249,795
lcl|NC_002695.2_cds_NP_312265.2_3976,587,545,660,761,2553
lcl|NC_002695.2_cds_NP_312266.1_3977,145,131,126,159,561
lcl|NC_002695.2_cds_NP_312267.2_3978,500,495,581,548,2124
lcl|NC_002695.2_cds_NP_312268.2_3979,168,156,170,175,669
lcl|NC_002695.2_cds_NP_312269.1_3980,119,69,100,114,402
lcl|NC_002695.2_cds_NP_312270.3_3981,223,190,220,246,879
lcl|NC_002695.2_cds_NP_312271.1_3982,379,486,386,474,1725
lcl|NC_002695.2_cds_NP_312272.1_3983,398,360,450,415,1623
lcl|NC_002695.2_cds_NP_312273.1_3984,286,297,351,419,1353
lcl|NC_002695.2_cds_NP_312274.1_3985,159,166,187,208,720
lcl|NC_002695.2_cds_NP_312275.2_3986,134,106,109,128,477
lcl|NC_002695.2_cds_NP_312276.2_3987,549,452,638,683,2322
lcl|NC_002695.2_cds_NP_312277.1_3988,54,63,61,50,228
lcl|NC_002695.2_cds_NP_312278.2_3989,483,567,632,640,2322
lcl|NC_002695.2_cds_NP_312279.1_3990,59,48,58,72,237
lcl|NC_002695.2_cds_NP_312280.1_3991,241,218,210,210,879
lcl|NC_002695.2_cds_NP_312282.3_3992,150,188,184,249,771
lcl|NC_002695.2_cds_NP_312281.2_3993,136,167,199,182,684
lcl|NC_002695.2_cds_NP_312283.1_3994,148,126,148,154,576
lcl|NC_002695.2_cds_NP_312284.1_3995,251,362,327,377,1317
lcl|NC_002695.2_cds_NP_312285.1_3996,495,444,504,642,2085
lcl|NC_002695.2_cds_NP_312286.1_3997,603,544,568,679,2394
lcl|NC_002695.2_cds_NP_312287.1_3998,658,583,727,738,2706
lcl|NC_002695.2_cds_NP_312288.2_3999,83,60,70,66,279
lcl|NC_002695.2_cds_NP_312289.1_4000,119,141,117,109,486
lcl|NC_002695.2_cds_NP_312290.2_4001,199,220,261,349,1029
lcl|NC_002695.2_cds_NP_312291.1_4002,330,273,265,359,1227
lcl|NC_002695.2_cds_NP_312292.1_4003,365,357,434,443,1599
lcl|NC_002695.2_cds_NP_312293.1_4004,184,159,212,204,759
lcl|NC_002695.2_cds_NP_312294.1_4005,155,225,199,252,831
lcl|NC_002695.2_cds_NP_312295.1_4006,78,75,75,99,327
lcl|NC_002695.2_cds_NP_312296.1_4007,344,338,386,438,1506
lcl|NC_002695.2_cds_NP_312297.2_4008,122,205,115,161,603
lcl|NC_002695.2_cds_NP_312298.1_4009,285,241,216,251,993
lcl|NC_002695.2_cds_NP_312299.2_4010,386,407,336,380,1509
lcl|NC_002695.2_cds_NP_312300.1_4011,606,596,584,662,2448
lcl|NC_002695.2_cds_NP_312301.1_4012,277,369,359,429,1434
lcl|NC_002695.2_cds_NP_312302.1_4013,308,309,326,353,1296
lcl|NC_002695.2_cds_NP_312303.1_4014,434,466,518,556,1974
lcl|NC_002695.2_cds_NP_312304.1_4015,491,533,562,601,2187
lcl|NC_002695.2_cds_NP_312305.1_4016,238,267,284,315,1104
lcl|NC_002695.2_cds_NP_312306.1_4017,125,170,140,159,594
lcl|NC_002695.2_cds_NP_312307.2_4018,322,322,284,368,1296
lcl|NC_002695.2_cds_NP_312312.1_4019,241,354,334,412,1341
lcl|NC_002695.2_cds_NP_312313.2_4020,139,126,122,141,528
lcl|NC_002695.2_cds_NP_312314.1_4021,222,234,258,282,996
lcl|NC_002695.2_cds_NP_312315.1_4022,172,158,166,200,696
lcl|NC_002695.2_cds_NP_312316.1_4023,273,238,258,269,1038
lcl|NC_002695.2_cds_NP_312317.1_4024,121,113,114,141,489
lcl|NC_002695.2_cds_NP_312318.1_4025,333,281,142,156,912
lcl|NC_002695.2_cds_NP_312320.1_4026,436,357,437,516,1746
lcl|NC_002695.2_cds_NP_312321.1_4027,137,80,119,105,441
lcl|NC_002695.2_cds_NP_312322.1_4028,170,157,186,231,744
lcl|NC_002695.2_cds_NP_312323.2_4029,241,205,273,352,1071
lcl|NC_002695.2_cds_NP_312324.1_4030,166,225,224,231,846
lcl|NC_002695.2_cds_NP_312325.1_4031,140,252,259,237,888
lcl|NC_002695.2_cds_NP_312326.1_4032,350,264,336,367,1317
lcl|NC_002695.2_cds_NP_312327.1_4033,183,188,172,204,747
lcl|NC_002695.2_cds_NP_312328.2_4034,155,155,176,228,714
lcl|NC_002695.2_cds_NP_312329.1_4035,178,170,206,214,768
lcl|NC_002695.2_cds_NP_312330.1_4036,206,348,330,394,1278
lcl|NC_002695.2_cds_NP_312331.1_4037,164,246,238,279,927
lcl|NC_002695.2_cds_NP_312332.1_4038,279,234,280,317,1110
lcl|NC_002695.2_cds_NP_312333.1_4039,82,86,92,124,384
lcl|NC_002695.2_cds_NP_312334.1_4040,144,145,118,121,528
lcl|NC_002695.2_cds_NP_312335.1_4041,76,59,55,77,267
lcl|NC_002695.2_cds_NP_312336.2_4042,290,214,273,327,1104
lcl|NC_002695.2_cds_NP_312337.1_4043,215,178,217,245,855
lcl|NC_002695.2_cds_NP_312338.1_4044,224,269,253,313,1059
lcl|NC_002695.2_cds_NP_312339.1_4045,143,152,171,203,669
lcl|NC_002695.2_cds_NP_312340.1_4046,411,285,338,463,1497
lcl|NC_002695.2_cds_NP_312341.1_4047,148,128,148,173,597
lcl|NC_002695.2_cds_NP_312342.1_4048,63,86,57,64,270
lcl|NC_002695.2_cds_NP_312343.1_4049,100,78,88,94,360
lcl|NC_002695.2_cds_NP_312344.1_4050,81,193,180,173,627
lcl|NC_002695.2_cds_NP_312345.1_4051,467,450,589,693,2199
lcl|NC_002695.2_cds_NP_312346.1_4052,58,60,65,63,246
lcl|NC_002695.2_cds_NP_312347.1_4053,122,204,185,155,666
lcl|NC_002695.2_cds_NP_312348.3_4054,154,115,136,153,558
lcl|NC_002695.2_cds_NP_312349.3_4055,210,341,307,393,1251
lcl|NC_002695.2_cds_NP_312350.2_4056,217,293,243,297,1050
lcl|NC_002695.2_cds_NP_312351.1_4057,119,85,85,89,378
lcl|NC_002695.2_cds_NP_312352.2_4058,289,284,243,243,1059
lcl|NC_002695.2_cds_NP_312353.2_4059,170,163,199,191,723
lcl|NC_002695.2_cds_NP_312354.2_4060,185,219,199,219,822
lcl|NC_002695.2_cds_NP_312355.1_4061,59,64,69,66,258
lcl|NC_002695.2_cds_NP_312356.1_4062,81,47,60,64,252
lcl|NC_002695.2_cds_NP_312357.1_4063,98,161,146,177,582
lcl|NC_002695.2_cds_NP_312358.1_4064,281,324,373,384,1362
lcl|NC_002695.2_cds_NP_312359.1_4065,81,79,105,89,354
lcl|NC_002695.2_cds_NP_312360.1_4066,349,363,490,475,1677
lcl|NC_002695.2_cds_NP_312361.1_4067,97,97,114,115,423
lcl|NC_002695.2_cds_NP_312362.1_4068,153,121,186,146,606
lcl|NC_002695.2_cds_NP_312363.2_4069,449,521,646,703,2319
lcl|NC_002695.2_cds_NP_312364.1_4070,139,110,188,148,585
lcl|NC_002695.2_cds_NP_312365.1_4071,231,233,369,337,1170
lcl|NC_002695.2_cds_NP_312366.1_4072,95,95,142,133,465
lcl|NC_002695.2_cds_NP_312367.1_4073,167,151,197,217,732
lcl|NC_002695.2_cds_NP_312368.1_4074,285,268,326,351,1230
lcl|NC_002695.2_cds_NP_312369.1_4075,132,123,169,164,588
lcl|NC_002695.2_cds_NP_312370.1_4076,399,332,453,391,1575
lcl|NC_002695.2_cds_NP_312371.1_4077,143,250,271,281,945
lcl|NC_002695.2_cds_NP_312372.1_4078,116,213,240,265,834
lcl|NC_002695.2_cds_NP_312373.1_4079,161,145,224,235,765
lcl|NC_002695.2_cds_NP_312374.1_4080,188,164,237,218,807
lcl|NC_002695.2_cds_NP_312375.1_4081,95,83,116,108,402
lcl|NC_002695.2_cds_NP_312376.2_4082,235,200,132,180,747
lcl|NC_002695.2_cds_NP_312377.1_4083,133,106,119,116,474
lcl|NC_002695.2_cds_NP_312378.1_4084,85,74,62,61,282
lcl|NC_002695.2_cds_NP_312379.1_4085,277,400,341,341,1359
lcl|NC_002695.2_cds_NP_312380.1_4086,344,345,407,413,1509
lcl|NC_002695.2_cds_NP_312381.1_4087,85,54,58,73,270
lcl|NC_002695.2_cds_NP_312382.1_4088,229,206,199,227,861
lcl|NC_002695.2_cds_NP_312383.1_4089,102,100,72,86,360
lcl|NC_002695.2_cds_NP_312384.1_4090,92,66,48,70,276
lcl|NC_002695.2_cds_NP_312385.2_4091,232,288,276,329,1125
lcl|NC_002695.2_cds_NP_312386.2_4092,575,616,740,805,2736
lcl|NC_002695.2_cds_NP_312387.1_4093,239,196,297,336,1068
lcl|NC_002695.2_cds_NP_312388.1_4094,549,471,280,323,1623
lcl|NC_002695.2_cds_NP_312389.1_4095,559,499,257,296,1611
lcl|NC_002695.2_cds_NP_312390.2_4096,216,338,242,257,1053
lcl|NC_002695.2_cds_NP_312391.1_4097,261,277,301,364,1203
lcl|NC_002695.2_cds_NP_312392.1_4098,293,402,379,426,1500
lcl|NC_002695.2_cds_NP_312393.1_4099,65,111,73,87,336
lcl|NC_002695.2_cds_NP_312394.1_4100,117,107,109,102,435
lcl|NC_002695.2_cds_NP_312395.1_4101,290,425,373,382,1470
lcl|NC_002695.2_cds_NP_312396.1_4102,148,161,189,255,753
lcl|NC_002695.2_cds_NP_312397.1_4103,499,428,535,581,2043
lcl|NC_002695.2_cds_NP_312398.1_4104,206,176,237,224,843
lcl|NC_002695.2_cds_NP_312399.1_4105,330,295,347,381,1353
lcl|NC_002695.2_cds_NP_312400.1_4106,83,94,89,88,354
lcl|NC_002695.2_cds_NP_312401.1_4107,223,370,326,371,1290
lcl|NC_002695.2_cds_NP_312402.1_4108,114,91,107,114,426
lcl|NC_002695.2_cds_NP_312403.1_4109,424,294,225,173,1116
lcl|NC_002695.2_cds_NP_312404.2_4110,159,150,124,134,567
lcl|NC_002695.2_cds_NP_312405.1_4111,160,162,109,100,531
lcl|NC_002695.2_cds_NP_312406.1_4112,277,244,233,275,1029
lcl|NC_002695.2_cds_NP_312407.1_4113,486,491,483,523,1983
lcl|NC_002695.2_cds_NP_312409.3_4114,236,197,250,232,915
lcl|NC_002695.2_cds_NP_312410.1_4115,330,321,348,339,1338
lcl|NC_002695.2_cds_NP_312411.1_4116,133,110,132,120,495
lcl|NC_002695.2_cds_NP_312412.1_4117,140,125,165,194,624
lcl|NC_002695.2_cds_NP_312413.1_4118,191,265,243,258,957
lcl|NC_002695.2_cds_NP_312414.1_4119,201,197,188,185,771
lcl|NC_002695.2_cds_NP_312415.2_4120,152,164,106,154,576
lcl|NC_002695.2_cds_NP_312416.3_4121,114,91,67,67,339
lcl|NC_002695.2_cds_NP_312417.1_4122,108,82,64,79,333
lcl|NC_002695.2_cds_NP_312418.1_4123,113,195,118,147,573
lcl|NC_002695.2_cds_NP_312419.1_4124,194,160,94,80,528
lcl|NC_002695.2_cds_YP_009502656.1_4125,75,69,62,73,279
lcl|NC_002695.2_cds_NP_312420.1_4126,297,235,318,308,1158
lcl|NC_002695.2_cds_NP_312421.1_4127,703,763,810,838,3114
lcl|NC_002695.2_cds_NP_312422.1_4128,208,212,164,145,729
lcl|NC_002695.2_cds_NP_312423.1_4129,235,254,151,185,825
lcl|NC_002695.2_cds_NP_312424.1_4130,320,320,377,384,1401
lcl|NC_002695.2_cds_NP_312425.1_4131,370,347,296,385,1398
lcl|NC_002695.2_cds_NP_312426.1_4132,382,376,434,458,1650
lcl|NC_002695.2_cds_NP_312427.1_4133,167,148,118,170,603
lcl|NC_002695.2_cds_NP_312428.3_4134,230,237,252,253,972
lcl|NC_002695.2_cds_NP_312429.1_4135,219,257,267,271,1014
lcl|NC_002695.2_cds_NP_312430.1_4136,226,361,363,373,1323
lcl|NC_002695.2_cds_NP_312431.2_4137,490,473,466,632,2061
lcl|NC_002695.2_cds_NP_312432.2_4138,175,189,193,211,768
lcl|NC_002695.2_cds_NP_312433.2_4139,219,185,245,281,930
lcl|NC_002695.2_cds_NP_312434.1_4140,365,320,392,420,1497
lcl|NC_002695.2_cds_NP_312435.1_4141,272,349,314,352,1287
lcl|NC_002695.2_cds_NP_312436.3_4142,443,492,488,527,1950
lcl|NC_002695.2_cds_NP_312438.1_4143,257,246,273,331,1107
lcl|NC_002695.2_cds_NP_312439.2_4144,516,519,618,669,2322
lcl|NC_002695.2_cds_NP_312440.2_4145,524,643,699,753,2619
lcl|NC_002695.2_cds_NP_312442.1_4146,52,50,43,44,189
lcl|NC_002695.2_cds_NP_312443.2_4147,390,403,382,385,1560
lcl|NC_002695.2_cds_NP_312444.2_4148,47,53,48,44,192
lcl|NC_002695.2_cds_NP_312445.1_4149,373,424,445,438,1680
lcl|NC_002695.2_cds_YP_009502657.1_4150,23,27,25,33,108
lcl|NC_002695.2_cds_NP_312446.1_4151,282,413,300,277,1272
lcl|NC_002695.2_cds_NP_312447.1_4152,231,207,279,288,1005
lcl|NC_002695.2_cds_NP_312448.1_4153,216,217,254,297,984
lcl|NC_002695.2_cds_NP_312449.1_4154,140,231,250,282,903
lcl|NC_002695.2_cds_NP_312450.1_4155,179,271,265,305,1020
lcl|NC_002695.2_cds_NP_312451.1_4156,439,341,414,414,1608
lcl|NC_002695.2_cds_NP_312452.3_4157,401,437,412,442,1692
lcl|NC_002695.2_cds_NP_312453.1_4158,142,117,119,153,531
lcl|NC_002695.2_cds_NP_312454.1_4159,285,268,238,265,1056
lcl|NC_002695.2_cds_NP_312457.3_4160,209,185,143,150,687
lcl|NC_002695.2_cds_NP_312458.2_4161,136,143,111,135,525
lcl|NC_002695.2_cds_NP_312459.1_4162,234,353,280,336,1203
lcl|NC_002695.2_cds_NP_312460.2_4163,188,162,168,181,699
lcl|NC_002695.2_cds_NP_312461.1_4164,146,131,132,155,564
lcl|NC_002695.2_cds_NP_312462.1_4165,108,106,101,126,441
lcl|NC_002695.2_cds_NP_312463.2_4166,527,539,580,688,2334
lcl|NC_002695.2_cds_NP_312464.1_4167,151,128,180,201,660
lcl|NC_002695.2_cds_NP_312465.2_4168,248,219,257,251,975
lcl|NC_002695.2_cds_NP_312466.2_4169,182,172,170,187,711
lcl|NC_002695.2_cds_NP_312467.1_4170,97,66,54,74,291
lcl|NC_002695.2_cds_NP_312468.1_4171,59,49,54,51,213
lcl|NC_002695.2_cds_YP_009502658.1_4172,61,69,33,50,213
lcl|NC_002695.2_cds_NP_312469.1_4173,480,443,538,609,2070
lcl|NC_002695.2_cds_NP_312470.1_4174,211,194,255,252,912
lcl|NC_002695.2_cds_YP_009502659.1_4175,75,83,67,75,300
lcl|NC_002695.2_cds_NP_312471.1_4176,221,308,223,244,996
lcl|NC_002695.2_cds_NP_312472.2_4177,125,133,81,99,438
lcl|NC_002695.2_cds_NP_312473.2_4178,78,124,65,75,342
lcl|NC_002695.2_cds_NP_312474.1_4179,319,343,344,449,1455
lcl|NC_002695.2_cds_NP_312475.1_4180,344,316,299,364,1323
lcl|NC_002695.2_cds_NP_312476.1_4181,322,239,204,228,993
lcl|NC_002695.2_cds_NP_312477.1_4182,432,383,350,377,1542
lcl|NC_002695.2_cds_NP_312478.1_4183,229,314,310,329,1182
lcl|NC_002695.2_cds_NP_312479.1_4184,316,288,278,297,1179
lcl|NC_002695.2_cds_NP_312480.1_4185,250,186,190,199,825
lcl|NC_002695.2_cds_NP_312481.1_4186,508,451,537,535,2031
lcl|NC_002695.2_cds_NP_312482.1_4187,307,288,321,338,1254
lcl|NC_002695.2_cds_NP_312483.1_4188,103,116,107,148,474
lcl|NC_002695.2_cds_NP_312484.1_4189,191,196,200,229,816
lcl|NC_002695.2_cds_NP_312485.1_4190,261,377,399,364,1401
lcl|NC_002695.2_cds_NP_312486.1_4191,479,416,515,561,1971
lcl|NC_002695.2_cds_NP_312487.1_4192,177,202,158,204,741
lcl|NC_002695.2_cds_NP_312488.1_4193,273,241,232,229,975
lcl|NC_002695.2_cds_NP_312489.1_4194,290,271,265,311,1137
lcl|NC_002695.2_cds_NP_312490.1_4195,70,105,72,77,324
lcl|NC_002695.2_cds_NP_312491.2_4196,364,334,382,459,1539
lcl|NC_002695.2_cds_NP_312492.1_4197,337,302,311,346,1296
lcl|NC_002695.2_cds_NP_312493.1_4198,286,282,286,298,1152
lcl|NC_002695.2_cds_NP_312494.1_4199,420,388,488,549,1845
lcl|NC_002695.2_cds_NP_312495.1_4200,299,310,353,430,1392
lcl|NC_002695.2_cds_NP_312496.1_4201,144,145,147,173,609
lcl|NC_002695.2_cds_NP_312497.1_4202,998,735,1214,1283,4230
lcl|NC_002695.2_cds_NP_312498.1_4203,176,139,61,86,462
lcl|NC_002695.2_cds_NP_312500.1_4204,269,269,281,318,1137
lcl|NC_002695.2_cds_NP_312501.1_4205,78,99,95,91,363
lcl|NC_002695.2_cds_NP_312502.1_4206,422,468,487,537,1914
lcl|NC_002695.2_cds_NP_312503.1_4207,290,255,284,320,1149
lcl|NC_002695.2_cds_NP_312504.1_4208,153,133,148,154,588
lcl|NC_002695.2_cds_YP_009502660.1_4209,56,51,49,54,210
lcl|NC_002695.2_cds_NP_312505.1_4210,115,65,81,102,363
lcl|NC_002695.2_cds_NP_312506.1_4211,218,149,114,101,582
lcl|NC_002695.2_cds_NP_312507.1_4212,1313,1053,1163,1238,4767
lcl|NC_002695.2_cds_NP_312508.1_4213,294,450,467,445,1656
lcl|NC_002695.2_cds_NP_312509.1_4214,191,166,207,213,777
lcl|NC_002695.2_cds_NP_312510.1_4215,249,281,289,372,1191
lcl|NC_002695.2_cds_NP_312511.1_4216,107,108,134,125,474
lcl|NC_002695.2_cds_NP_312512.1_4217,194,191,202,235,822
lcl|NC_002695.2_cds_NP_312513.1_4218,214,227,274,305,1020
lcl|NC_002695.2_cds_NP_312514.1_4219,119,109,124,116,468
lcl|NC_002695.2_cds_NP_312515.1_4220,66,57,60,69,252
lcl|NC_002695.2_cds_NP_312516.1_4221,110,107,91,124,432
lcl|NC_002695.2_cds_NP_312517.1_4222,391,331,391,432,1545
lcl|NC_002695.2_cds_NP_312518.2_4223,326,216,338,380,1260
lcl|NC_002695.2_cds_NP_312519.2_4224,240,215,260,245,960
lcl|NC_002695.2_cds_NP_312520.1_4225,273,276,221,247,1017
lcl|NC_002695.2_cds_NP_312521.1_4226,230,261,246,289,1026
lcl|NC_002695.2_cds_NP_312522.1_4227,260,287,287,363,1197
lcl|NC_002695.2_cds_NP_312523.3_4228,286,265,143,179,873
lcl|NC_002695.2_cds_NP_312524.1_4229,238,216,238,241,933
lcl|NC_002695.2_cds_NP_312525.1_4230,240,243,275,289,1047
lcl|NC_002695.2_cds_NP_312526.1_4231,260,236,223,274,993
lcl|NC_002695.2_cds_NP_312527.1_4232,368,415,209,217,1209
lcl|NC_002695.2_cds_NP_312528.1_4233,369,351,190,233,1143
lcl|NC_002695.2_cds_NP_312529.1_4234,365,338,139,172,1014
lcl|NC_002695.2_cds_NP_312530.1_4235,268,222,93,125,708
lcl|NC_002695.2_cds_NP_312531.1_4236,355,338,145,170,1008
lcl|NC_002695.2_cds_NP_312532.2_4237,213,209,171,205,798
lcl|NC_002695.2_cds_NP_312533.1_4238,291,293,253,288,1125
lcl|NC_002695.2_cds_NP_312534.3_4239,273,291,242,253,1059
lcl|NC_002695.2_cds_NP_312535.1_4240,275,314,359,330,1278
lcl|NC_002695.2_cds_NP_312536.1_4241,109,117,113,141,480
lcl|NC_002695.2_cds_NP_312537.1_4242,186,187,184,253,810
lcl|NC_002695.2_cds_NP_312538.1_4243,61,39,34,34,168
lcl|NC_002695.2_cds_NP_312539.1_4244,57,54,65,61,237
lcl|NC_002695.2_cds_NP_312540.2_4245,174,176,144,175,669
lcl|NC_002695.2_cds_NP_312541.2_4246,283,284,331,323,1221
lcl|NC_002695.2_cds_NP_312542.2_4247,93,115,120,131,459
lcl|NC_002695.2_cds_NP_312543.2_4248,146,137,154,160,597
lcl|NC_002695.2_cds_NP_312544.1_4249,144,157,148,193,642
lcl|NC_002695.2_cds_NP_312545.1_4250,171,137,181,228,717
lcl|NC_002695.2_cds_NP_312546.1_4251,223,176,208,257,864
lcl|NC_002695.2_cds_NP_312547.2_4252,258,177,179,211,825
lcl|NC_002695.2_cds_NP_312548.2_4253,113,176,164,165,618
lcl|NC_002695.2_cds_NP_312549.2_4254,409,385,375,514,1683
lcl|NC_002695.2_cds_NP_312550.1_4255,160,159,151,154,624
lcl|NC_002695.2_cds_NP_312551.1_4256,77,52,68,79,276
lcl|NC_002695.2_cds_NP_312552.1_4257,522,449,570,568,2109
lcl|NC_002695.2_cds_NP_312553.2_4258,154,137,182,184,657
lcl|NC_002695.2_cds_NP_312554.1_4259,487,412,585,598,2082
lcl|NC_002695.2_cds_NP_312555.2_4260,202,229,186,250,867
lcl|NC_002695.2_cds_NP_312556.1_4261,203,349,280,374,1206
lcl|NC_002695.2_cds_NP_312557.1_4262,254,372,374,392,1392
lcl|NC_002695.2_cds_NP_312558.1_4263,407,378,449,476,1710
lcl|NC_002695.2_cds_NP_312559.1_4264,537,581,544,657,2319
lcl|NC_002695.2_cds_NP_312560.2_4265,303,394,329,357,1383
lcl|NC_002695.2_cds_NP_312561.1_4266,338,281,267,296,1182
lcl|NC_002695.2_cds_NP_312562.2_4267,90,64,82,79,315
lcl|NC_002695.2_cds_NP_312564.2_4268,193,158,180,216,747
lcl|NC_002695.2_cds_NP_312566.1_4269,93,78,106,98,375
lcl|NC_002695.2_cds_NP_312567.3_4270,109,130,130,123,492
lcl|NC_002695.2_cds_NP_312568.1_4271,56,42,49,51,198
lcl|NC_002695.2_cds_NP_312569.1_4272,91,61,97,93,342
lcl|NC_002695.2_cds_NP_312572.2_4273,102,81,107,91,381
lcl|NC_002695.2_cds_NP_312573.1_4274,69,76,98,105,348
lcl|NC_002695.2_cds_NP_312574.1_4275,346,293,426,474,1539
lcl|NC_002695.2_cds_NP_312577.1_4276,179,162,216,190,747
lcl|NC_002695.2_cds_NP_312578.1_4277,88,85,38,68,279
lcl|NC_002695.2_cds_NP_312579.1_4278,73,69,33,47,222
lcl|NC_002695.2_cds_NP_312580.1_4279,125,123,66,94,408
lcl|NC_002695.2_cds_NP_312581.1_4280,266,227,200,246,939
lcl|NC_002695.2_cds_NP_312582.1_4281,311,284,235,295,1125
lcl|NC_002695.2_cds_NP_312583.1_4282,182,166,103,128,579
lcl|NC_002695.2_cds_NP_312584.1_4283,343,341,152,220,1056
lcl|NC_002695.2_cds_NP_312585.1_4284,396,346,243,236,1221
lcl|NC_002695.2_cds_NP_312586.1_4285,820,790,544,651,2805
lcl|NC_002695.2_cds_NP_312587.1_4286,157,150,69,95,471
lcl|NC_002695.2_cds_NP_312588.1_4287,461,394,373,449,1677
lcl|NC_002695.2_cds_NP_312589.1_4288,201,145,124,142,612
lcl|NC_002695.2_cds_NP_312590.1_4289,123,133,61,67,384
lcl|NC_002695.2_cds_NP_312591.1_4290,157,144,98,108,507
lcl|NC_002695.2_cds_NP_312592.1_4291,275,299,144,200,918
lcl|NC_002695.2_cds_NP_312594.2_4292,122,86,48,65,321
lcl|NC_002695.2_cds_NP_312595.1_4293,361,385,261,334,1341
lcl|NC_002695.2_cds_NP_312596.1_4294,558,648,367,455,2028
lcl|NC_002695.2_cds_NP_312597.1_4295,99,148,41,66,354
lcl|NC_002695.2_cds_NP_312598.1_4296,85,70,65,80,300
lcl|NC_002695.2_cds_NP_312599.2_4297,121,98,88,71,378
lcl|NC_002695.2_cds_NP_312600.1_4298,209,153,102,109,573
lcl|NC_002695.2_cds_NP_312601.1_4299,148,143,86,79,456
lcl|NC_002695.2_cds_NP_312602.1_4300,526,438,283,292,1539
lcl|NC_002695.2_cds_NP_312603.1_4301,156,137,82,81,456
lcl|NC_002695.2_cds_NP_312604.1_4302,141,122,58,93,414
lcl|NC_002695.2_cds_NP_312605.1_4303,133,116,54,69,372
lcl|NC_002695.2_cds_NP_312606.1_4304,195,133,60,71,459
lcl|NC_002695.2_cds_NP_312607.1_4305,344,341,155,198,1038
lcl|NC_002695.2_cds_NP_312608.1_4306,221,296,130,130,777
lcl|NC_002695.2_cds_NP_312609.1_4307,75,91,52,52,270
lcl|NC_002695.2_cds_NP_312610.2_4308,199,239,104,112,654
lcl|NC_002695.2_cds_NP_312611.2_4309,282,184,82,106,654
lcl|NC_002695.2_cds_NP_312612.1_4310,209,201,77,113,600
lcl|NC_002695.2_cds_NP_312613.2_4311,152,63,39,61,315
lcl|NC_002695.2_cds_NP_312614.2_4312,101,48,28,42,219
lcl|NC_002695.2_cds_NP_312615.2_4313,134,84,66,88,372
lcl|NC_002695.2_cds_NP_312617.2_4314,362,313,244,227,1146
lcl|NC_002695.2_cds_NP_312618.1_4315,283,237,162,137,819
lcl|NC_002695.2_cds_NP_312619.2_4316,32,19,21,36,108
lcl|NC_002695.2_cds_NP_312620.2_4317,65,47,52,43,207
lcl|NC_002695.2_cds_NP_312621.1_4318,189,281,228,226,924
lcl|NC_002695.2_cds_NP_312622.1_4319,252,184,170,213,819
lcl|NC_002695.2_cds_YP_009502661.1_4320,94,72,59,69,294
lcl|NC_002695.2_cds_NP_312623.3_4321,204,382,293,360,1239
lcl|NC_002695.2_cds_NP_312624.1_4322,119,87,65,83,354
lcl|NC_002695.2_cds_NP_312625.1_4323,99,79,74,72,324
lcl|NC_002695.2_cds_NP_312626.2_4324,97,119,109,128,453
lcl|NC_002695.2_cds_NP_312629.1_4325,393,409,476,489,1767
lcl|NC_002695.2_cds_NP_312630.1_4326,280,371,349,392,1392
lcl|NC_002695.2_cds_NP_312631.2_4327,224,366,320,410,1320
lcl|NC_002695.2_cds_NP_312632.2_4328,269,373,399,462,1503
lcl|NC_002695.2_cds_NP_312633.1_4329,116,132,153,190,591
lcl|NC_002695.2_cds_NP_312634.2_4330,384,333,176,211,1104
lcl|NC_002695.2_cds_NP_312635.1_4331,106,105,42,62,315
lcl|NC_002695.2_cds_NP_312636.1_4332,154,160,68,101,483
lcl|NC_002695.2_cds_NP_312637.1_4333,228,194,101,131,654
lcl|NC_002695.2_cds_NP_312638.1_4334,79,73,69,70,291
lcl|NC_002695.2_cds_NP_312639.1_4335,376,363,448,502,1689
lcl|NC_002695.2_cds_NP_312640.1_4336,18,22,30,29,99
lcl|NC_002695.2_cds_YP_009502662.1_4337,23,28,21,18,90
lcl|NC_002695.2_cds_NP_312641.2_4338,189,328,298,370,1185
lcl|NC_002695.2_cds_NP_312642.1_4339,110,125,116,147,498
lcl|NC_002695.2_cds_NP_312643.1_4340,80,100,94,89,363
lcl|NC_002695.2_cds_NP_312644.1_4341,68,100,80,100,348
lcl|NC_002695.2_cds_NP_312645.1_4342,105,126,102,117,450
lcl|NC_002695.2_cds_NP_312646.1_4343,375,339,376,404,1494
lcl|NC_002695.2_cds_NP_312647.1_4344,343,460,435,478,1716
lcl|NC_002695.2_cds_NP_312648.2_4345,275,233,199,187,894
lcl|NC_002695.2_cds_NP_312649.2_4346,336,290,331,366,1323
lcl|NC_002695.2_cds_NP_312650.2_4347,347,428,401,441,1617
lcl|NC_002695.2_cds_NP_312651.1_4348,182,162,168,205,717
lcl|NC_002695.2_cds_NP_312652.2_4349,325,459,400,478,1662
lcl|NC_002695.2_cds_NP_312653.2_4350,125,95,106,103,429
lcl|NC_002695.2_cds_NP_312654.1_4351,115,105,98,96,414
lcl|NC_002695.2_cds_NP_312655.3_4352,67,50,73,71,261
lcl|NC_002695.2_cds_NP_312656.3_4353,283,271,315,346,1215
lcl|NC_002695.2_cds_NP_312657.2_4354,263,259,252,291,1065
lcl|NC_002695.2_cds_NP_312658.1_4355,196,180,134,147,657
lcl|NC_002695.2_cds_NP_312659.1_4356,212,191,206,204,813
lcl|NC_002695.2_cds_NP_312660.2_4357,105,91,89,114,399
lcl|NC_002695.2_cds_NP_312661.1_4358,599,488,641,687,2415
lcl|NC_002695.2_cds_NP_312662.1_4359,252,234,283,305,1074
lcl|NC_002695.2_cds_NP_312663.1_4360,247,253,284,317,1101
lcl|NC_002695.2_cds_NP_312664.1_4361,343,308,371,382,1404
lcl|NC_002695.2_cds_NP_312665.1_4362,30,38,39,34,141
lcl|NC_002695.2_cds_NP_312666.2_4363,73,72,98,84,327
lcl|NC_002695.2_cds_NP_312667.1_4364,392,371,457,427,1647
lcl|NC_002695.2_cds_NP_312668.1_4365,300,294,366,405,1365
lcl|NC_002695.2_cds_NP_312671.1_4366,25,23,15,12,75
lcl|NC_002695.2_cds_NP_312672.2_4367,372,325,343,376,1416
lcl|NC_002695.2_cds_NP_312673.1_4368,252,413,294,289,1248
lcl|NC_002695.2_cds_NP_312674.1_4369,207,353,294,322,1176
lcl|NC_002695.2_cds_NP_312675.1_4370,235,225,249,251,960
lcl|NC_002695.2_cds_NP_312676.2_4371,180,179,197,194,750
lcl|NC_002695.2_cds_NP_312677.1_4372,134,133,136,164,567
lcl|NC_002695.2_cds_NP_312678.1_4373,226,391,332,389,1338
lcl|NC_002695.2_cds_NP_312679.1_4374,170,156,164,176,666
lcl|NC_002695.2_cds_NP_312680.1_4375,900,757,312,440,2409
lcl|NC_002695.2_cds_NP_307391.1_4376,55,42,14,24,135
lcl|NC_002695.2_cds_NP_312687.1_4377,185,163,167,211,726
lcl|NC_002695.2_cds_NP_312688.1_4378,194,171,210,199,774
lcl|NC_002695.2_cds_NP_312689.1_4379,165,223,229,274,891
lcl|NC_002695.2_cds_NP_312690.1_4380,174,258,252,276,960
lcl|NC_002695.2_cds_NP_312691.1_4381,275,234,251,281,1041
lcl|NC_002695.2_cds_NP_312692.1_4382,320,289,232,242,1083
lcl|NC_002695.2_cds_NP_312693.1_4383,290,273,247,261,1071
lcl|NC_002695.2_cds_NP_312694.1_4384,664,641,600,630,2535
lcl|NC_002695.2_cds_NP_312697.1_4385,164,168,127,144,603
lcl|NC_002695.2_cds_NP_312698.1_4386,416,433,469,512,1830
lcl|NC_002695.2_cds_NP_312699.1_4387,338,305,331,397,1371
lcl|NC_002695.2_cds_NP_312700.1_4388,107,82,111,120,420
lcl|NC_002695.2_cds_NP_312701.1_4389,317,306,366,394,1383
lcl|NC_002695.2_cds_NP_312702.1_4390,220,182,222,240,864
lcl|NC_002695.2_cds_NP_312703.1_4391,355,365,414,408,1542
lcl|NC_002695.2_cds_NP_312704.1_4392,128,133,127,146,534
lcl|NC_002695.2_cds_NP_312705.1_4393,135,87,119,130,471
lcl|NC_002695.2_cds_NP_312706.1_4394,40,70,54,76,240
lcl|NC_002695.2_cds_NP_312707.2_4395,173,233,203,207,816
lcl|NC_002695.2_cds_NP_312708.2_4396,69,114,80,118,381
lcl|NC_002695.2_cds_NP_312709.1_4397,156,163,149,156,624
lcl|NC_002695.2_cds_NP_312710.1_4398,434,427,496,533,1890
lcl|NC_002695.2_cds_NP_312711.1_4399,118,105,105,116,444
lcl|NC_002695.2_cds_NP_312712.1_4400,128,98,118,115,459
lcl|NC_002695.2_cds_NP_312713.1_4401,215,222,247,309,993
lcl|NC_002695.2_cds_NP_312714.1_4402,350,332,369,401,1452
lcl|NC_002695.2_cds_NP_312715.2_4403,385,367,363,382,1497
lcl|NC_002695.2_cds_NP_312716.1_4404,374,537,448,510,1869
lcl|NC_002695.2_cds_NP_312717.1_4405,120,101,104,95,420
lcl|NC_002695.2_cds_NP_312718.1_4406,379,353,357,417,1506
lcl|NC_002695.2_cds_NP_312719.1_4407,186,265,234,281,966
lcl|NC_002695.2_cds_NP_312720.1_4408,235,185,216,255,891
lcl|NC_002695.2_cds_NP_312721.1_4409,226,216,224,264,930
lcl|NC_002695.2_cds_NP_312722.1_4410,247,245,251,250,993
lcl|NC_002695.2_cds_NP_312723.1_4411,316,412,355,345,1428
lcl|NC_002695.2_cds_NP_312724.2_4412,184,168,162,179,693
lcl|NC_002695.2_cds_NP_312725.1_4413,224,209,200,207,840
lcl|NC_002695.2_cds_NP_312726.1_4414,95,79,79,86,339
lcl|NC_002695.2_cds_NP_312727.2_4415,407,343,375,396,1521
lcl|NC_002695.2_cds_NP_312728.1_4416,20,26,21,32,99
lcl|NC_002695.2_cds_NP_312729.1_4417,380,374,431,462,1647
lcl|NC_002695.2_cds_NP_312730.1_4418,70,63,72,59,264
lcl|NC_002695.2_cds_NP_312731.1_4419,209,211,240,270,930
lcl|NC_002695.2_cds_NP_312732.1_4420,421,389,508,533,1851
lcl|NC_002695.2_cds_NP_312733.1_4421,321,310,437,477,1545
lcl|NC_002695.2_cds_NP_312734.1_4422,192,185,238,279,894
lcl|NC_002695.2_cds_NP_312735.1_4423,371,310,363,432,1476
lcl|NC_002695.2_cds_NP_312736.1_4424,74,64,70,74,282
lcl|NC_002695.2_cds_NP_312737.1_4425,145,115,94,96,450
lcl|NC_002695.2_cds_NP_312738.1_4426,502,439,491,590,2022
lcl|NC_002695.2_cds_NP_312739.1_4427,334,354,378,419,1485
lcl|NC_002695.2_cds_NP_312740.1_4428,304,297,327,338,1266
lcl|NC_002695.2_cds_NP_312741.2_4429,90,71,80,89,330
lcl|NC_002695.2_cds_NP_312742.1_4430,24,28,25,25,102
lcl|NC_002695.2_cds_NP_312743.1_4431,329,295,320,316,1260
lcl|NC_002695.2_cds_YP_009502663.1_4432,51,79,40,49,219
lcl|NC_002695.2_cds_NP_312744.1_4433,215,344,266,279,1104
lcl|NC_002695.2_cds_NP_312745.2_4434,248,244,254,301,1047
lcl|NC_002695.2_cds_NP_312746.2_4435,276,265,280,310,1131
lcl|NC_002695.2_cds_NP_312747.1_4436,286,295,314,368,1263
lcl|NC_002695.2_cds_NP_312748.1_4437,256,241,267,304,1068
lcl|NC_002695.2_cds_NP_312749.1_4438,193,206,220,263,882
lcl|NC_002695.2_cds_NP_312750.2_4439,150,152,174,199,675
lcl|NC_002695.2_cds_NP_312751.1_4440,254,258,293,326,1131
lcl|NC_002695.2_cds_NP_312752.1_4441,218,366,280,387,1251
lcl|NC_002695.2_cds_NP_312753.1_4442,237,271,263,309,1080
lcl|NC_002695.2_cds_NP_312754.1_4443,229,415,344,365,1353
lcl|NC_002695.2_cds_NP_312755.1_4444,175,170,179,217,741
lcl|NC_002695.2_cds_NP_312756.1_4445,258,385,332,411,1386
lcl|NC_002695.2_cds_NP_312757.1_4446,295,304,295,342,1236
lcl|NC_002695.2_cds_NP_312758.1_4447,414,368,444,430,1656
lcl|NC_002695.2_cds_NP_312759.1_4448,304,236,306,351,1197
lcl|NC_002695.2_cds_NP_312760.1_4449,328,228,327,317,1200
lcl|NC_002695.2_cds_NP_312761.1_4450,172,176,190,203,741
lcl|NC_002695.2_cds_NP_312762.3_4451,217,207,259,280,963
lcl|NC_002695.2_cds_NP_312763.1_4452,590,632,649,676,2547
lcl|NC_002695.2_cds_NP_312764.1_4453,85,63,78,95,321
lcl|NC_002695.2_cds_YP_009502664.1_4454,56,42,59,47,204
lcl|NC_002695.2_cds_NP_312766.2_4455,173,201,201,250,825
lcl|NC_002695.2_cds_NP_312767.1_4456,146,167,176,219,708
lcl|NC_002695.2_cds_NP_312768.1_4457,210,202,236,249,897
lcl|NC_002695.2_cds_NP_312769.1_4458,162,154,193,208,717
lcl|NC_002695.2_cds_NP_312770.1_4459,492,419,581,671,2163
lcl|NC_002695.2_cds_NP_312771.1_4460,245,225,193,240,903
lcl|NC_002695.2_cds_NP_312772.1_4461,194,207,165,199,765
lcl|NC_002695.2_cds_NP_312773.1_4462,225,228,238,260,951
lcl|NC_002695.2_cds_YP_009502665.1_4463,174,156,84,78,492
lcl|NC_002695.2_cds_NP_312774.1_4464,302,280,149,118,849
lcl|NC_002695.2_cds_NP_312775.1_4465,84,115,34,67,300
lcl|NC_002695.2_cds_NP_312776.1_4466,174,264,207,243,888
lcl|NC_002695.2_cds_NP_312777.2_4467,111,108,115,134,468
lcl|NC_002695.2_cds_NP_312778.1_4468,214,209,209,238,870
lcl|NC_002695.2_cds_NP_312779.3_4469,416,410,481,529,1836
lcl|NC_002695.2_cds_NP_312780.1_4470,106,191,137,187,621
lcl|NC_002695.2_cds_NP_312781.1_4471,126,175,149,171,621
lcl|NC_002695.2_cds_NP_312782.1_4472,220,255,260,288,1023
lcl|NC_002695.2_cds_NP_312783.1_4473,184,205,192,220,801
lcl|NC_002695.2_cds_NP_312784.1_4474,159,249,230,262,900
lcl|NC_002695.2_cds_NP_312785.1_4475,208,204,266,276,954
lcl|NC_002695.2_cds_NP_312786.1_4476,521,480,579,682,2262
lcl|NC_002695.2_cds_NP_312787.2_4477,183,189,217,227,816
lcl|NC_002695.2_cds_NP_312788.1_4478,164,187,196,215,762
lcl|NC_002695.2_cds_NP_312789.1_4479,383,287,356,402,1428
lcl|NC_002695.2_cds_NP_312790.1_4480,177,185,186,208,756
lcl|NC_002695.2_cds_NP_312791.1_4481,129,135,154,188,606
lcl|NC_002695.2_cds_NP_312792.1_4482,398,424,381,438,1641
lcl|NC_002695.2_cds_NP_312793.1_4483,85,62,53,70,270
lcl|NC_002695.2_cds_NP_312794.1_4484,136,95,136,149,516
lcl|NC_002695.2_cds_NP_312795.1_4485,152,223,192,210,777
lcl|NC_002695.2_cds_NP_312796.1_4486,171,187,198,227,783
lcl|NC_002695.2_cds_NP_312797.1_4487,127,117,128,117,489
lcl|NC_002695.2_cds_NP_312798.1_4488,365,357,360,412,1494
lcl|NC_002695.2_cds_NP_312799.1_4489,151,180,162,209,702
lcl|NC_002695.2_cds_NP_312800.1_4490,229,263,302,370,1164
lcl|NC_002695.2_cds_NP_312801.1_4491,538,444,582,626,2190
lcl|NC_002695.2_cds_NP_312802.1_4492,330,294,348,360,1332
lcl|NC_002695.2_cds_NP_312803.2_4493,135,137,141,202,615
lcl|NC_002695.2_cds_NP_312804.1_4494,257,426,364,405,1452
lcl|NC_002695.2_cds_NP_312805.1_4495,141,120,138,147,546
lcl|NC_002695.2_cds_NP_312806.2_4496,147,124,104,153,528
lcl|NC_002695.2_cds_NP_312807.1_4497,143,144,129,169,585
lcl|NC_002695.2_cds_NP_312808.1_4498,82,64,54,70,270
lcl|NC_002695.2_cds_NP_312809.1_4499,245,266,228,248,987
lcl|NC_002695.2_cds_NP_312810.1_4500,167,160,123,177,627
lcl|NC_002695.2_cds_NP_312811.2_4501,453,382,276,320,1431
lcl|NC_002695.2_cds_NP_312812.1_4502,233,275,205,220,933
lcl|NC_002695.2_cds_NP_312813.1_4503,732,605,677,773,2787
lcl|NC_002695.2_cds_NP_312814.1_4504,170,135,146,182,633
lcl|NC_002695.2_cds_NP_312815.1_4505,161,79,121,146,507
lcl|NC_002695.2_cds_NP_312816.2_4506,322,321,361,370,1374
lcl|NC_002695.2_cds_NP_312817.1_4507,305,305,365,435,1410
lcl|NC_002695.2_cds_NP_312818.1_4508,244,233,280,293,1050
lcl|NC_002695.2_cds_NP_312819.1_4509,339,318,390,363,1410
lcl|NC_002695.2_cds_NP_312820.1_4510,435,414,477,498,1824
lcl|NC_002695.2_cds_NP_312821.1_4511,204,159,160,188,711
lcl|NC_002695.2_cds_NP_312822.1_4512,292,262,202,225,981
lcl|NC_002695.2_cds_NP_312823.1_4513,298,392,259,317,1266
lcl|NC_002695.2_cds_NP_312824.3_4514,221,219,162,157,759
lcl|NC_002695.2_cds_NP_312825.1_4515,333,443,300,328,1404
lcl|NC_002695.2_cds_NP_312826.1_4516,273,383,369,361,1386
lcl|NC_002695.2_cds_NP_312827.1_4517,501,446,549,541,2037
lcl|NC_002695.2_cds_NP_312828.1_4518,185,266,211,214,876
lcl|NC_002695.2_cds_NP_312829.1_4519,232,236,233,202,903
lcl|NC_002695.2_cds_NP_312830.1_4520,309,272,309,352,1242
lcl|NC_002695.2_cds_NP_312831.1_4521,211,198,229,241,879
lcl|NC_002695.2_cds_NP_312832.1_4522,194,204,245,254,897
lcl|NC_002695.2_cds_NP_312833.2_4523,201,193,210,293,897
lcl|NC_002695.2_cds_NP_312834.2_4524,188,183,197,218,786
lcl|NC_002695.2_cds_NP_312835.2_4525,143,157,136,164,600
lcl|NC_002695.2_cds_NP_312836.1_4526,179,252,228,214,873
lcl|NC_002695.2_cds_NP_312837.1_4527,104,94,104,136,438
lcl|NC_002695.2_cds_NP_312838.2_4528,222,199,239,282,942
lcl|NC_002695.2_cds_NP_312839.1_4529,320,250,146,178,894
lcl|NC_002695.2_cds_NP_312840.1_4530,279,261,167,208,915
lcl|NC_002695.2_cds_NP_312842.3_4531,65,51,34,69,219
lcl|NC_002695.2_cds_NP_312843.3_4532,72,63,39,69,243
lcl|NC_002695.2_cds_NP_312844.1_4533,220,196,245,269,930
lcl|NC_002695.2_cds_NP_312845.1_4534,130,173,158,175,636
lcl|NC_002695.2_cds_NP_312846.1_4535,219,182,236,266,903
lcl|NC_002695.2_cds_NP_312847.1_4536,739,635,827,850,3051
lcl|NC_002695.2_cds_NP_312848.1_4537,192,200,190,252,834
lcl|NC_002695.2_cds_NP_312849.1_4538,336,241,222,257,1056
lcl|NC_002695.2_cds_NP_312850.1_4539,434,450,440,425,1749
lcl|NC_002695.2_cds_NP_312851.1_4540,277,236,250,308,1071
lcl|NC_002695.2_cds_NP_312852.1_4541,274,368,394,404,1440
lcl|NC_002695.2_cds_NP_312853.1_4542,117,104,119,107,447
lcl|NC_002695.2_cds_NP_312854.1_4543,406,358,283,348,1395
lcl|NC_002695.2_cds_NP_312855.1_4544,86,69,79,81,315
lcl|NC_002695.2_cds_NP_312856.1_4545,192,175,244,214,825
lcl|NC_002695.2_cds_NP_312857.1_4546,272,283,333,372,1260
lcl|NC_002695.2_cds_NP_312858.1_4547,327,337,399,407,1470
lcl|NC_002695.2_cds_NP_312859.1_4548,189,219,209,220,837
lcl|NC_002695.2_cds_NP_312860.3_4549,215,258,217,249,939
lcl|NC_002695.2_cds_NP_312861.3_4550,164,122,173,162,621
lcl|NC_002695.2_cds_NP_312862.2_4551,205,263,226,290,984
lcl|NC_002695.2_cds_NP_312863.2_4552,164,158,150,203,675
lcl|NC_002695.2_cds_NP_312864.1_4553,308,316,340,410,1374
lcl|NC_002695.2_cds_NP_312865.1_4554,168,170,175,186,699
lcl|NC_002695.2_cds_NP_312866.2_4555,148,103,119,131,501
lcl|NC_002695.2_cds_NP_312867.1_4556,177,257,205,264,903
lcl|NC_002695.2_cds_NP_312868.1_4557,217,226,237,283,963
lcl|NC_002695.2_cds_NP_312869.1_4558,277,212,227,274,990
lcl|NC_002695.2_cds_NP_312870.1_4559,190,197,170,199,756
lcl|NC_002695.2_cds_NP_312871.1_4560,200,163,193,212,768
lcl|NC_002695.2_cds_NP_312872.1_4561,181,122,161,136,600
lcl|NC_002695.2_cds_NP_312873.1_4562,97,129,84,131,441
lcl|NC_002695.2_cds_NP_312874.1_4563,77,81,62,80,300
lcl|NC_002695.2_cds_NP_312875.1_4564,131,113,85,100,429
lcl|NC_002695.2_cds_NP_312876.1_4565,192,161,191,203,747
lcl|NC_002695.2_cds_NP_312877.1_4566,240,203,265,303,1011
lcl|NC_002695.2_cds_NP_312878.1_4567,365,325,381,438,1509
lcl|NC_002695.2_cds_NP_312879.1_4568,156,259,203,228,846
lcl|NC_002695.2_cds_NP_312880.2_4569,83,43,47,67,240
lcl|NC_002695.2_cds_NP_312881.2_4570,174,178,129,146,627
lcl|NC_002695.2_cds_NP_312882.1_4571,199,206,134,136,675
lcl|NC_002695.2_cds_NP_312883.1_4572,105,129,105,147,486
lcl|NC_002695.2_cds_NP_312884.1_4573,187,240,236,264,927
lcl|NC_002695.2_cds_NP_312885.1_4574,362,271,340,359,1332
lcl|NC_002695.2_cds_NP_312886.1_4575,138,119,129,145,531
lcl|NC_002695.2_cds_NP_312887.2_4576,228,133,245,249,855
lcl|NC_002695.2_cds_NP_312888.1_4577,254,239,266,267,1026
lcl|NC_002695.2_cds_NP_312889.1_4578,459,487,608,645,2199
lcl|NC_002695.2_cds_NP_312890.1_4579,60,48,57,48,213
lcl|NC_002695.2_cds_NP_312891.1_4580,1014,721,1178,1272,4185
lcl|NC_002695.2_cds_YP_009502666.1_4581,84,86,29,38,237
lcl|NC_002695.2_cds_YP_009502667.1_4582,86,81,48,64,279
lcl|NC_002695.2_cds_NP_312893.1_4583,159,133,156,161,609
lcl|NC_002695.2_cds_NP_312894.1_4584,92,61,77,88,318
lcl|NC_002695.2_cds_NP_312895.1_4585,262,262,288,349,1161
lcl|NC_002695.2_cds_NP_312896.1_4586,480,528,666,759,2433
lcl|NC_002695.2_cds_NP_312897.1_4587,214,210,216,251,891
lcl|NC_002695.2_cds_NP_312898.1_4588,485,477,568,651,2181
lcl|NC_002695.2_cds_NP_312899.2_4589,158,256,219,273,906
lcl|NC_002695.2_cds_NP_312900.1_4590,154,137,162,165,618
lcl|NC_002695.2_cds_NP_312901.2_4591,255,250,273,326,1104
lcl|NC_002695.2_cds_NP_312902.1_4592,169,138,165,191,663
lcl|NC_002695.2_cds_NP_312903.2_4593,584,540,705,673,2502
lcl|NC_002695.2_cds_NP_312906.1_4594,92,68,68,93,321
lcl|NC_002695.2_cds_NP_312907.1_4595,562,519,595,622,2298
lcl|NC_002695.2_cds_NP_312908.3_4596,189,205,209,276,879
lcl|NC_002695.2_cds_NP_312909.1_4597,75,76,78,113,342
lcl|NC_002695.2_cds_NP_312910.1_4598,208,191,247,206,852
lcl|NC_002695.2_cds_NP_312911.1_4599,442,422,446,424,1734
lcl|NC_002695.2_cds_NP_312912.1_4600,652,526,742,732,2652
lcl|NC_002695.2_cds_NP_312913.1_4601,286,272,302,292,1152
lcl|NC_002695.2_cds_NP_312914.1_4602,226,242,259,278,1005
lcl|NC_002695.2_cds_NP_312915.2_4603,180,169,178,247,774
lcl|NC_002695.2_cds_NP_312916.1_4604,303,295,336,440,1374
lcl|NC_002695.2_cds_NP_312917.1_4605,203,201,230,284,918
lcl|NC_002695.2_cds_NP_312918.2_4606,352,319,369,361,1401
lcl|NC_002695.2_cds_NP_312919.1_4607,270,273,279,345,1167
lcl|NC_002695.2_cds_NP_312920.1_4608,250,389,285,393,1317
lcl|NC_002695.2_cds_NP_312921.3_4609,170,166,170,199,705
lcl|NC_002695.2_cds_NP_312922.1_4610,70,111,85,94,360
lcl|NC_002695.2_cds_NP_312923.1_4611,292,246,276,287,1101
lcl|NC_002695.2_cds_NP_312924.1_4612,461,464,435,485,1845
lcl|NC_002695.2_cds_NP_312925.2_4613,196,220,212,230,858
lcl|NC_002695.2_cds_NP_312926.1_4614,293,257,223,256,1029
lcl|NC_002695.2_cds_NP_312927.1_4615,248,241,195,282,966
lcl|NC_002695.2_cds_NP_312928.2_4616,249,265,202,211,927
lcl|NC_002695.2_cds_NP_312930.1_4617,290,263,307,325,1185
lcl|NC_002695.2_cds_NP_312931.1_4618,73,101,89,121,384
lcl|NC_002695.2_cds_NP_312932.1_4619,128,136,124,158,546
lcl|NC_002695.2_cds_NP_312933.1_4620,114,92,109,114,429
lcl|NC_002695.2_cds_NP_312934.1_4621,192,148,172,193,705
lcl|NC_002695.2_cds_NP_312935.1_4622,121,116,122,139,498
lcl|NC_002695.2_cds_NP_312936.1_4623,112,85,70,99,366
lcl|NC_002695.2_cds_NP_312937.1_4624,1013,899,1027,1090,4029
lcl|NC_002695.2_cds_NP_312938.1_4625,1011,938,1090,1185,4224
lcl|NC_002695.2_cds_NP_312939.1_4626,127,127,91,99,444
lcl|NC_002695.2_cds_NP_312940.1_4627,258,249,312,315,1134
lcl|NC_002695.2_cds_NP_312941.2_4628,159,160,219,233,771
lcl|NC_002695.2_cds_YP_009502668.1_4629,49,43,52,57,201
lcl|NC_002695.2_cds_NP_312942.2_4630,168,158,198,232,756
lcl|NC_002695.2_cds_NP_312943.1_4631,129,139,171,197,636
lcl|NC_002695.2_cds_NP_312944.1_4632,457,386,523,530,1896
lcl|NC_002695.2_cds_NP_312945.1_4633,122,120,115,120,477
lcl|NC_002695.2_cds_NP_312946.1_4634,182,180,184,228,774
lcl|NC_002695.2_cds_NP_312947.1_4635,231,236,281,317,1065
lcl|NC_002695.2_cds_NP_312948.1_4636,131,148,185,208,672
lcl|NC_002695.2_cds_NP_312949.1_4637,165,142,128,156,591
lcl|NC_002695.2_cds_NP_312950.1_4638,83,58,65,67,273
lcl|NC_002695.2_cds_NP_312951.2_4639,146,149,167,174,636
lcl|NC_002695.2_cds_NP_312952.2_4640,115,83,96,132,426
lcl|NC_002695.2_cds_NP_312953.1_4641,328,297,347,405,1377
lcl|NC_002695.2_cds_NP_312954.1_4642,294,286,327,419,1326
lcl|NC_002695.2_cds_NP_312955.1_4643,301,239,342,408,1290
lcl|NC_002695.2_cds_NP_312956.1_4644,364,336,444,446,1590
lcl|NC_002695.2_cds_NP_312957.1_4645,90,117,85,152,444
lcl|NC_002695.2_cds_NP_312958.1_4646,226,238,240,226,930
lcl|NC_002695.2_cds_NP_312959.1_4647,420,359,403,420,1602
lcl|NC_002695.2_cds_NP_312960.1_4648,305,273,341,386,1305
lcl|NC_002695.2_cds_NP_312961.1_4649,390,430,451,466,1737
lcl|NC_002695.2_cds_NP_312962.1_4650,722,639,422,404,2187
lcl|NC_002695.2_cds_NP_312963.2_4651,194,182,218,231,825
lcl|NC_002695.2_cds_NP_312964.1_4652,882,738,988,1076,3684
lcl|NC_002695.2_cds_NP_312965.1_4653,322,405,438,467,1632
lcl|NC_002695.2_cds_NP_312966.1_4654,148,166,179,197,690
lcl|NC_002695.2_cds_NP_312968.1_4655,297,279,328,326,1230
lcl|NC_002695.2_cds_NP_312970.1_4656,175,125,96,135,531
lcl|NC_002695.2_cds_NP_312971.1_4657,69,64,53,63,249
lcl|NC_002695.2_cds_NP_312972.1_4658,543,416,527,605,2091
lcl|NC_002695.2_cds_NP_312973.1_4659,214,199,237,283,933
lcl|NC_002695.2_cds_NP_312974.1_4660,60,68,39,55,222
lcl|NC_002695.2_cds_NP_312975.1_4661,66,46,73,70,255
lcl|NC_002695.2_cds_NP_312976.1_4662,67,64,55,96,282
lcl|NC_002695.2_cds_NP_312977.1_4663,82,66,45,80,273
lcl|NC_002695.2_cds_NP_312978.1_4664,89,76,60,69,294
lcl|NC_002695.2_cds_NP_312979.1_4665,158,98,115,160,531
lcl|NC_002695.2_cds_NP_312980.1_4666,135,150,115,143,543
lcl|NC_002695.2_cds_NP_312981.1_4667,111,142,112,169,534
lcl|NC_002695.2_cds_NP_312982.1_4668,122,138,119,137,516
lcl|NC_002695.2_cds_NP_312983.2_4669,159,140,114,139,552
lcl|NC_002695.2_cds_YP_009502669.1_4670,45,73,28,40,186
lcl|NC_002695.2_cds_NP_312984.2_4671,106,92,60,75,333
lcl|NC_002695.2_cds_NP_312985.1_4672,63,45,36,54,198
lcl|NC_002695.2_cds_NP_312986.1_4673,77,89,60,71,297
lcl|NC_002695.2_cds_NP_312987.1_4674,123,94,139,154,510
lcl|NC_002695.2_cds_NP_312988.1_4675,101,90,113,122,426
lcl|NC_002695.2_cds_NP_312989.1_4676,111,109,141,140,501
lcl|NC_002695.2_cds_NP_312990.2_4677,84,88,113,144,429
lcl|NC_002695.2_cds_NP_312992.1_4678,44,48,59,77,228
lcl|NC_002695.2_cds_NP_312993.1_4679,77,62,83,87,309
lcl|NC_002695.2_cds_NP_312994.1_4680,59,65,73,94,291
lcl|NC_002695.2_cds_NP_312995.1_4681,140,100,161,181,582
lcl|NC_002695.2_cds_NP_312996.1_4682,361,368,437,499,1665
lcl|NC_002695.2_cds_NP_312997.2_4683,341,320,432,497,1590
lcl|NC_002695.2_cds_NP_312998.1_4684,330,257,348,391,1326
lcl|NC_002695.2_cds_NP_312999.1_4685,107,98,120,149,474
lcl|NC_002695.2_cds_NP_313000.1_4686,262,214,324,325,1125
lcl|NC_002695.2_cds_NP_313001.1_4687,206,211,260,271,948
lcl|NC_002695.2_cds_NP_313002.1_4688,89,71,97,130,387
lcl|NC_002695.2_cds_NP_313003.1_4689,80,96,116,128,420
lcl|NC_002695.2_cds_NP_313004.1_4690,120,119,157,165,561
lcl|NC_002695.2_cds_NP_313005.1_4691,64,42,69,71,246
lcl|NC_002695.2_cds_NP_313006.1_4692,326,335,395,447,1503
lcl|NC_002695.2_cds_NP_313007.1_4693,89,72,89,116,366
lcl|NC_002695.2_cds_NP_313008.1_4694,109,90,119,159,477
lcl|NC_002695.2_cds_NP_313009.1_4695,416,434,525,701,2076
lcl|NC_002695.2_cds_NP_313010.2_4696,288,298,359,405,1350
lcl|NC_002695.2_cds_NP_313011.1_4697,222,235,300,368,1125
lcl|NC_002695.2_cds_NP_313012.2_4698,146,125,153,191,615
lcl|NC_002695.2_cds_NP_313013.1_4699,82,106,112,138,438
lcl|NC_002695.2_cds_NP_313014.2_4700,252,214,280,337,1083
lcl|NC_002695.2_cds_NP_313015.1_4701,129,149,130,153,561
lcl|NC_002695.2_cds_NP_313016.1_4702,240,210,216,246,912
lcl|NC_002695.2_cds_NP_313017.1_4703,154,135,100,133,522
lcl|NC_002695.2_cds_NP_313018.1_4704,54,60,37,53,204
lcl|NC_002695.2_cds_NP_313019.1_4705,154,127,121,159,561
lcl|NC_002695.2_cds_NP_313020.1_4706,528,469,478,565,2040
lcl|NC_002695.2_cds_NP_313021.1_4707,50,48,44,41,183
lcl|NC_002695.2_cds_NP_313022.1_4708,71,51,55,69,246
lcl|NC_002695.2_cds_NP_313023.2_4709,148,130,92,95,465
lcl|NC_002695.2_cds_NP_313024.1_4710,65,36,58,42,201
lcl|NC_002695.2_cds_NP_313025.1_4711,213,179,161,185,738
lcl|NC_002695.2_cds_NP_313027.1_4712,154,219,214,211,798
lcl|NC_002695.2_cds_NP_313028.1_4713,144,124,115,112,495
lcl|NC_002695.2_cds_NP_313029.1_4714,107,94,93,114,408
lcl|NC_002695.2_cds_NP_313030.1_4715,215,176,185,231,807
lcl|NC_002695.2_cds_NP_313031.3_4716,260,223,210,255,948
lcl|NC_002695.2_cds_NP_313032.1_4717,240,178,210,245,873
lcl|NC_002695.2_cds_NP_313033.1_4718,88,47,66,72,273
lcl|NC_002695.2_cds_NP_313034.1_4719,293,327,353,377,1350
lcl|NC_002695.2_cds_NP_313035.1_4720,423,378,425,424,1650
lcl|NC_002695.2_cds_NP_313036.1_4721,47,48,69,79,243
lcl|NC_002695.2_cds_NP_313037.2_4722,158,130,175,176,639
lcl|NC_002695.2_cds_NP_313038.1_4723,161,149,204,224,738
lcl|NC_002695.2_cds_NP_313039.1_4724,496,463,531,607,2097
lcl|NC_002695.2_cds_NP_313040.1_4725,78,130,101,102,411
lcl|NC_002695.2_cds_NP_313041.1_4726,308,440,353,375,1476
lcl|NC_002695.2_cds_NP_313044.1_4727,338,246,295,312,1191
lcl|NC_002695.2_cds_NP_313045.1_4728,258,244,292,322,1116
lcl|NC_002695.2_cds_NP_313046.1_4729,336,308,335,362,1341
lcl|NC_002695.2_cds_NP_313047.1_4730,236,190,266,229,921
lcl|NC_002695.2_cds_NP_313048.1_4731,544,531,231,275,1581
lcl|NC_002695.2_cds_NP_313049.2_4732,116,121,121,140,498
lcl|NC_002695.2_cds_NP_313050.1_4733,169,253,183,268,873
lcl|NC_002695.2_cds_NP_313051.2_4734,533,555,672,664,2424
lcl|NC_002695.2_cds_NP_313052.1_4735,79,97,86,107,369
lcl|NC_002695.2_cds_NP_313053.1_4736,150,141,138,180,609
lcl|NC_002695.2_cds_NP_313054.4_4737,219,373,328,406,1326
lcl|NC_002695.2_cds_NP_313055.1_4738,79,42,29,60,210
lcl|NC_002695.2_cds_NP_313056.2_4739,124,117,124,151,516
lcl|NC_002695.2_cds_NP_313057.1_4740,314,273,133,177,897
lcl|NC_002695.2_cds_NP_313058.1_4741,243,241,239,315,1038
lcl|NC_002695.2_cds_NP_313059.2_4742,43,79,48,73,243
lcl|NC_002695.2_cds_NP_313060.1_4743,250,218,238,278,984
lcl|NC_002695.2_cds_NP_313061.1_4744,348,312,364,392,1416
lcl|NC_002695.2_cds_NP_313062.1_4745,232,248,278,322,1080
lcl|NC_002695.2_cds_NP_313063.1_4746,276,287,296,335,1194
lcl|NC_002695.2_cds_YP_009502670.1_4747,129,128,46,57,360
lcl|NC_002695.2_cds_NP_313064.1_4748,185,176,179,174,714
lcl|NC_002695.2_cds_NP_313065.1_4749,103,98,112,104,417
lcl|NC_002695.2_cds_NP_313066.1_4750,100,75,82,100,357
lcl|NC_002695.2_cds_NP_313067.1_4751,639,606,763,815,2823
lcl|NC_002695.2_cds_NP_313068.1_4752,116,109,137,175,537
lcl|NC_002695.2_cds_NP_313069.2_4753,55,75,74,78,282
lcl|NC_002695.2_cds_NP_313070.1_4754,414,464,343,366,1587
lcl|NC_002695.2_cds_NP_313071.1_4755,72,86,90,76,324
lcl|NC_002695.2_cds_NP_313072.1_4756,116,106,104,139,465
lcl|NC_002695.2_cds_NP_313073.1_4757,218,373,345,414,1350
lcl|NC_002695.2_cds_NP_313074.1_4758,294,432,423,501,1650
lcl|NC_002695.2_cds_NP_313075.1_4759,465,402,222,204,1293
lcl|NC_002695.2_cds_NP_313076.1_4760,302,440,431,477,1650
lcl|NC_002695.2_cds_NP_313077.1_4761,74,85,76,80,315
lcl|NC_002695.2_cds_NP_313078.1_4762,459,392,536,572,1959
lcl|NC_002695.2_cds_NP_313079.1_4763,396,283,377,381,1437
lcl|NC_002695.2_cds_NP_313080.2_4764,142,116,158,151,567
lcl|NC_002695.2_cds_NP_313081.1_4765,130,155,183,204,672
lcl|NC_002695.2_cds_NP_313082.1_4766,139,270,239,309,957
lcl|NC_002695.2_cds_NP_313083.2_4767,255,451,416,501,1623
lcl|NC_002695.2_cds_NP_313084.1_4768,90,93,90,111,384
lcl|NC_002695.2_cds_NP_313085.1_4769,161,125,155,156,597
lcl|NC_002695.2_cds_NP_313086.1_4770,251,363,310,390,1314
lcl|NC_002695.2_cds_NP_313087.1_4771,193,155,152,190,690
lcl|NC_002695.2_cds_NP_313088.1_4772,532,453,559,604,2148
lcl|NC_002695.2_cds_NP_313089.1_4773,343,305,406,413,1467
lcl|NC_002695.2_cds_NP_313090.2_4774,434,500,564,554,2052
lcl|NC_002695.2_cds_NP_313091.1_4775,229,233,288,282,1032
lcl|NC_002695.2_cds_NP_313092.1_4776,57,87,74,58,276
lcl|NC_002695.2_cds_NP_313093.2_4777,518,424,529,515,1986
lcl|NC_002695.2_cds_NP_313094.1_4778,150,167,171,220,708
lcl|NC_002695.2_cds_NP_313095.1_4779,216,207,272,307,1002
lcl|NC_002695.2_cds_NP_313096.1_4780,180,209,220,252,861
lcl|NC_002695.2_cds_NP_313097.1_4781,160,166,179,179,684
lcl|NC_002695.2_cds_NP_313098.1_4782,246,167,245,284,942
lcl|NC_002695.2_cds_NP_313099.1_4783,180,244,268,283,975
lcl|NC_002695.2_cds_NP_313100.1_4784,359,294,420,448,1521
lcl|NC_002695.2_cds_NP_313101.1_4785,506,459,601,705,2271
lcl|NC_002695.2_cds_YP_009502671.1_4786,86,62,88,94,330
lcl|NC_002695.2_cds_NP_313102.1_4787,139,162,218,240,759
lcl|NC_002695.2_cds_NP_313103.1_4788,91,86,120,129,426
lcl|NC_002695.2_cds_NP_313104.1_4789,119,104,171,164,558
lcl|NC_002695.2_cds_NP_313105.1_4790,247,190,344,356,1137
lcl|NC_002695.2_cds_NP_313106.1_4791,144,121,233,183,681
lcl|NC_002695.2_cds_NP_313107.1_4792,140,155,217,247,759
lcl|NC_002695.2_cds_NP_313108.1_4793,194,155,257,240,846
lcl|NC_002695.2_cds_NP_313109.1_4794,222,185,333,325,1065
lcl|NC_002695.2_cds_NP_313110.1_4795,107,108,196,174,585
lcl|NC_002695.2_cds_NP_313111.1_4796,97,72,152,132,453
lcl|NC_002695.2_cds_NP_313112.1_4797,146,128,246,206,726
lcl|NC_002695.2_cds_NP_313113.2_4798,123,171,260,226,780
lcl|NC_002695.2_cds_NP_313114.1_4799,279,183,284,271,1017
lcl|NC_002695.2_cds_NP_313115.1_4800,168,154,249,218,789
lcl|NC_002695.2_cds_NP_313116.1_4801,120,99,118,107,444
lcl|NC_002695.2_cds_NP_313117.1_4802,111,70,75,80,336
lcl|NC_002695.2_cds_NP_313118.1_4803,540,545,546,598,2229
lcl|NC_002695.2_cds_NP_313119.2_4804,172,206,228,273,879
lcl|NC_002695.2_cds_NP_313120.1_4805,315,435,338,415,1503
lcl|NC_002695.2_cds_NP_313121.2_4806,261,241,287,312,1101
lcl|NC_002695.2_cds_NP_313122.1_4807,168,145,168,188,669
lcl|NC_002695.2_cds_NP_313123.2_4808,410,414,424,396,1644
lcl|NC_002695.2_cds_NP_313124.1_4809,246,364,357,371,1338
lcl|NC_002695.2_cds_NP_313125.1_4810,234,215,166,147,762
lcl|NC_002695.2_cds_NP_313126.1_4811,563,509,625,574,2271
lcl|NC_002695.2_cds_NP_313127.1_4812,247,208,240,214,909
lcl|NC_002695.2_cds_NP_313128.1_4813,326,312,343,375,1356
lcl|NC_002695.2_cds_NP_313129.3_4814,293,466,305,346,1410
lcl|NC_002695.2_cds_NP_313130.1_4815,123,160,165,182,630
lcl|NC_002695.2_cds_NP_313131.1_4816,432,321,475,419,1647
lcl|NC_002695.2_cds_NP_313132.1_4817,264,377,336,364,1341
lcl|NC_002695.2_cds_NP_313133.1_4818,194,170,189,167,720
lcl|NC_002695.2_cds_NP_313134.1_4819,435,377,390,430,1632
lcl|NC_002695.2_cds_NP_313135.1_4820,62,59,47,63,231
lcl|NC_002695.2_cds_NP_313136.1_4821,98,62,45,68,273
lcl|NC_002695.2_cds_NP_313137.1_4822,91,103,50,53,297
lcl|NC_002695.2_cds_YP_009502672.1_4823,42,71,32,29,174
lcl|NC_002695.2_cds_NP_313138.1_4824,398,393,345,382,1518
lcl|NC_002695.2_cds_NP_313139.1_4825,285,420,358,395,1458
lcl|NC_002695.2_cds_NP_313140.1_4826,586,537,527,498,2148
lcl|NC_002695.2_cds_NP_313141.1_4827,267,406,319,343,1335
lcl|NC_002695.2_cds_NP_313142.1_4828,458,434,332,315,1539
lcl|NC_002695.2_cds_NP_313143.2_4829,142,124,150,160,576
lcl|NC_002695.2_cds_NP_313144.1_4830,363,414,472,449,1698
lcl|NC_002695.2_cds_NP_313145.1_4831,90,78,91,80,339
lcl|NC_002695.2_cds_NP_313146.1_4832,253,366,351,332,1302
lcl|NC_002695.2_cds_NP_313147.2_4833,402,329,354,352,1437
lcl|NC_002695.2_cds_NP_313148.1_4834,98,152,102,125,477
lcl|NC_002695.2_cds_NP_313149.1_4835,239,368,301,349,1257
lcl|NC_002695.2_cds_NP_313150.1_4836,79,71,61,83,294
lcl|NC_002695.2_cds_NP_313151.1_4837,433,334,402,478,1647
lcl|NC_002695.2_cds_NP_313152.2_4838,84,72,83,115,354
lcl|NC_002695.2_cds_NP_313153.1_4839,266,212,192,200,870
lcl|NC_002695.2_cds_NP_313154.1_4840,245,238,267,279,1029
lcl|NC_002695.2_cds_NP_313155.1_4841,144,139,136,148,567
lcl|NC_002695.2_cds_YP_009502673.1_4842,26,31,41,28,126
lcl|NC_002695.2_cds_YP_009502674.1_4843,39,38,31,39,147
lcl|NC_002695.2_cds_NP_313156.2_4844,59,89,71,99,318
lcl|NC_002695.2_cds_NP_313157.1_4845,117,130,139,148,534
lcl|NC_002695.2_cds_NP_313158.1_4846,305,257,288,284,1134
lcl|NC_002695.2_cds_NP_313159.1_4847,61,104,88,107,360
lcl|NC_002695.2_cds_NP_313160.1_4848,100,102,94,100,396
lcl|NC_002695.2_cds_NP_313161.1_4849,184,157,200,194,735
lcl|NC_002695.2_cds_NP_313162.1_4850,425,369,489,526,1809
lcl|NC_002695.2_cds_NP_313163.2_4851,229,239,234,276,978
lcl|NC_002695.2_cds_NP_313164.2_4852,300,465,312,381,1458
lcl|NC_002695.2_cds_NP_313165.1_4853,716,755,896,957,3324
lcl|NC_002695.2_cds_NP_313166.1_4854,234,212,268,255,969
lcl|NC_002695.2_cds_NP_313167.2_4855,252,233,276,292,1053
lcl|NC_002695.2_cds_NP_313168.2_4856,132,121,132,161,546
lcl|NC_002695.2_cds_NP_313170.2_4857,273,257,297,313,1140
lcl|NC_002695.2_cds_NP_313169.2_4858,323,330,402,478,1533
lcl|NC_002695.2_cds_NP_313171.1_4859,104,119,110,129,462
lcl|NC_002695.2_cds_NP_313172.1_4860,320,282,355,381,1338
lcl|NC_002695.2_cds_NP_313173.1_4861,435,370,517,526,1848
lcl|NC_002695.2_cds_NP_313174.1_4862,214,229,219,289,951
lcl|NC_002695.2_cds_NP_313175.1_4863,81,77,75,76,309
lcl|NC_002695.2_cds_NP_313176.1_4864,297,296,310,378,1281
lcl|NC_002695.2_cds_NP_313177.1_4865,319,237,324,380,1260
lcl|NC_002695.2_cds_NP_313178.1_4866,249,220,250,286,1005
lcl|NC_002695.2_cds_NP_313179.1_4867,41,60,36,61,198
lcl|NC_002695.2_cds_NP_313180.1_4868,286,313,329,371,1299
lcl|NC_002695.2_cds_NP_313181.1_4869,101,117,90,118,426
lcl|NC_002695.2_cds_NP_313182.2_4870,587,513,614,728,2442
lcl|NC_002695.2_cds_NP_313183.1_4871,165,156,196,215,732
lcl|NC_002695.2_cds_NP_313184.1_4872,128,120,74,80,402
lcl|NC_002695.2_cds_NP_313185.1_4873,202,142,160,195,699
lcl|NC_002695.2_cds_NP_313186.1_4874,176,174,139,171,660
lcl|NC_002695.2_cds_NP_313187.1_4875,98,128,83,90,399
lcl|NC_002695.2_cds_NP_313188.1_4876,160,164,147,168,639
lcl|NC_002695.2_cds_NP_313189.1_4877,263,284,280,337,1164
lcl|NC_002695.2_cds_NP_313190.4_4878,329,406,378,513,1626
lcl|NC_002695.2_cds_NP_313191.3_4879,73,62,67,74,276
lcl|NC_002695.2_cds_NP_313192.2_4880,93,77,72,88,330
lcl|NC_002695.2_cds_NP_313193.1_4881,168,185,192,205,750
lcl|NC_002695.2_cds_NP_313194.1_4882,220,154,177,205,756
lcl|NC_002695.2_cds_NP_313195.2_4883,264,243,263,295,1065
lcl|NC_002695.2_cds_NP_313196.2_4884,280,377,371,370,1398
lcl|NC_002695.2_cds_NP_313197.1_4885,83,67,73,83,306
lcl|NC_002695.2_cds_NP_313198.1_4886,115,101,114,135,465
lcl|NC_002695.2_cds_NP_313199.1_4887,147,133,176,195,651
lcl|NC_002695.2_cds_NP_313200.1_4888,189,174,208,284,855
lcl|NC_002695.2_cds_NP_313201.1_4889,167,136,176,208,687
lcl|NC_002695.2_cds_NP_313202.1_4890,84,65,59,68,276
lcl|NC_002695.2_cds_NP_313203.1_4891,103,84,103,106,396
lcl|NC_002695.2_cds_NP_313204.1_4892,78,74,78,85,315
lcl|NC_002695.2_cds_NP_313205.1_4893,58,50,69,51,228
lcl|NC_002695.2_cds_NP_313206.1_4894,123,104,102,121,450
lcl|NC_002695.2_cds_NP_313207.2_4895,161,152,128,117,558
lcl|NC_002695.2_cds_NP_313209.1_4896,118,116,96,102,432
lcl|NC_002695.2_cds_NP_313210.3_4897,312,243,283,311,1149
lcl|NC_002695.2_cds_NP_313211.2_4898,162,124,178,175,639
lcl|NC_002695.2_cds_NP_313212.2_4899,142,134,163,182,621
lcl|NC_002695.2_cds_NP_313213.1_4900,255,422,322,414,1413
lcl|NC_002695.2_cds_NP_313214.1_4901,184,127,170,182,663
lcl|NC_002695.2_cds_NP_313215.2_4902,168,261,261,276,966
lcl|NC_002695.2_cds_NP_313217.3_4903,221,177,227,236,861
lcl|NC_002695.2_cds_NP_313216.2_4904,80,85,85,131,381
lcl|NC_002695.2_cds_NP_313218.1_4905,541,436,448,519,1944
lcl|NC_002695.2_cds_NP_313219.1_4906,169,159,189,224,741
lcl|NC_002695.2_cds_NP_313220.1_4907,317,280,139,203,939
lcl|NC_002695.2_cds_NP_313221.1_4908,144,119,133,159,555
lcl|NC_002695.2_cds_NP_313222.2_4909,62,56,39,50,207
lcl|NC_002695.2_cds_NP_313223.1_4910,328,339,334,343,1344
lcl|NC_002695.2_cds_NP_313224.1_4911,144,151,173,171,639
lcl|NC_002695.2_cds_NP_313225.1_4912,413,395,438,488,1734
lcl|NC_002695.2_cds_NP_313226.1_4913,932,775,947,1126,3780
lcl|NC_002695.2_cds_NP_313227.1_4914,91,75,80,96,342
lcl|NC_002695.2_cds_NP_313229.2_4915,74,51,57,70,252
lcl|NC_002695.2_cds_NP_313230.2_4916,60,80,68,107,315
lcl|NC_002695.2_cds_NP_313231.1_4917,147,112,139,133,531
lcl|NC_002695.2_cds_NP_313232.1_4918,282,192,222,261,957
lcl|NC_002695.2_cds_NP_313233.1_4919,353,314,440,396,1503
lcl|NC_002695.2_cds_NP_313234.2_4920,178,254,262,329,1023
lcl|NC_002695.2_cds_NP_313235.2_4921,186,294,234,282,996
lcl|NC_002695.2_cds_NP_313236.1_4922,256,237,251,255,999
lcl|NC_002695.2_cds_NP_313237.1_4923,304,310,327,433,1374
lcl|NC_002695.2_cds_NP_313238.1_4924,155,105,131,161,552
lcl|NC_002695.2_cds_NP_313239.1_4925,321,295,335,402,1353
lcl|NC_002695.2_cds_NP_313240.2_4926,121,76,91,99,387
lcl|NC_002695.2_cds_NP_313241.1_4927,117,112,119,117,465
lcl|NC_002695.2_cds_NP_313242.1_4928,537,457,557,588,2139
lcl|NC_002695.2_cds_NP_313243.1_4929,402,373,430,451,1656
lcl|NC_002695.2_cds_NP_313244.1_4930,283,358,374,407,1422
lcl|NC_002695.2_cds_NP_313245.1_4931,235,204,255,254,948
lcl|NC_002695.2_cds_NP_313246.1_4932,621,656,640,780,2697
lcl|NC_002695.2_cds_NP_313247.2_4933,104,80,104,99,387
lcl|NC_002695.2_cds_NP_313248.1_4934,129,106,115,112,462
lcl|NC_002695.2_cds_NP_313249.1_4935,227,208,261,240,936
lcl|NC_002695.2_cds_NP_313250.1_4936,25,42,37,31,135
lcl|NC_002695.2_cds_NP_313252.1_4937,104,105,87,100,396
lcl|NC_002695.2_cds_NP_313253.1_4938,157,171,177,209,714
lcl|NC_002695.2_cds_NP_313255.2_4939,144,154,138,158,594
lcl|NC_002695.2_cds_NP_313256.2_4940,124,105,101,123,453
lcl|NC_002695.2_cds_NP_313257.1_4941,668,545,242,318,1773
lcl|NC_002695.2_cds_NP_313258.1_4942,265,219,245,276,1005
lcl|NC_002695.2_cds_NP_313259.1_4943,122,87,88,120,417
lcl|NC_002695.2_cds_NP_313260.2_4944,126,126,109,143,504
lcl|NC_002695.2_cds_NP_313261.1_4945,299,450,185,263,1197
lcl|NC_002695.2_cds_NP_313262.1_4946,710,571,769,806,2856
lcl|NC_002695.2_cds_NP_313263.1_4947,110,93,113,128,444
lcl|NC_002695.2_cds_NP_313264.1_4948,353,325,378,456,1512
lcl|NC_002695.2_cds_NP_313265.1_4949,231,266,284,320,1101
lcl|NC_002695.2_cds_NP_313266.2_4950,225,272,265,321,1083
lcl|NC_002695.2_cds_NP_313267.1_4951,366,332,343,462,1503
lcl|NC_002695.2_cds_NP_313268.2_4952,214,245,238,323,1020
lcl|NC_002695.2_cds_NP_313269.1_4953,522,523,405,500,1950
lcl|NC_002695.2_cds_NP_313270.1_4954,75,75,79,98,327
lcl|NC_002695.2_cds_NP_313271.2_4955,219,189,209,271,888
lcl|NC_002695.2_cds_NP_313272.2_4956,135,94,62,87,378
lcl|NC_002695.2_cds_NP_313273.1_4957,90,76,85,82,333
lcl|NC_002695.2_cds_NP_313275.1_4958,127,112,117,112,468
lcl|NC_002695.2_cds_NP_313276.2_4959,133,139,122,176,570
lcl|NC_002695.2_cds_NP_313277.1_4960,437,359,246,275,1317
lcl|NC_002695.2_cds_NP_313278.1_4961,253,177,173,171,774
lcl|NC_002695.2_cds_NP_313279.2_4962,101,124,93,141,459
lcl|NC_002695.2_cds_NP_313280.1_4963,218,203,184,223,828
lcl|NC_002695.2_cds_NP_313281.1_4964,240,187,204,221,852
lcl|NC_002695.2_cds_NP_313282.2_4965,93,91,59,66,309
lcl|NC_002695.2_cds_NP_313283.1_4966,361,318,194,231,1104
lcl|NC_002695.2_cds_NP_313284.1_4967,239,201,126,142,708
lcl|NC_002695.2_cds_NP_313285.1_4968,553,470,303,327,1653
lcl|NC_002695.2_cds_NP_313286.2_4969,997,1035,615,713,3360
lcl|NC_002695.2_cds_NP_313287.1_4970,1629,1600,1426,1660,6315
lcl|NC_002695.2_cds_NP_313288.2_4971,769,654,688,748,2859
lcl|NC_002695.2_cds_NP_313289.1_4972,1219,1152,1213,1351,4935
lcl|NC_002695.2_cds_NP_313290.1_4973,1531,1454,1594,1763,6342
lcl|NC_002695.2_cds_NP_313291.1_4974,540,517,470,588,2115
lcl|NC_002695.2_cds_NP_313293.2_4975,54,51,70,71,246
lcl|NC_002695.2_cds_NP_313295.1_4976,264,246,235,236,981
lcl|NC_002695.2_cds_NP_313296.2_4977,332,284,218,273,1107
lcl|NC_002695.2_cds_NP_313297.2_4978,223,186,144,164,717
lcl|NC_002695.2_cds_NP_313298.1_4979,164,179,120,140,603
lcl|NC_002695.2_cds_NP_313299.1_4980,155,163,123,156,597
lcl|NC_002695.2_cds_NP_313300.1_4981,125,140,133,151,549
lcl|NC_002695.2_cds_NP_313301.2_4982,120,126,109,143,498
lcl|NC_002695.2_cds_NP_313302.3_4983,224,179,149,174,726
lcl|NC_002695.2_cds_NP_313303.1_4984,697,665,595,680,2637
lcl|NC_002695.2_cds_NP_313304.1_4985,126,143,132,130,531
lcl|NC_002695.2_cds_NP_313305.1_4986,131,108,128,137,504
lcl|NC_002695.2_cds_NP_313306.1_4987,210,242,212,239,903
lcl|NC_002695.2_cds_NP_313307.1_4988,258,370,328,388,1344
lcl|NC_002695.2_cds_NP_313308.1_4989,296,245,325,319,1185
lcl|NC_002695.2_cds_NP_313309.1_4990,319,299,396,447,1461
lcl|NC_002695.2_cds_NP_313310.2_4991,181,156,177,212,726
lcl|NC_002695.2_cds_NP_313311.3_4992,274,227,163,167,831
lcl|NC_002695.2_cds_NP_313312.2_4993,94,109,96,94,393
lcl|NC_002695.2_cds_NP_313313.1_4994,254,261,326,332,1173
lcl|NC_002695.2_cds_NP_313314.1_4995,98,117,117,130,462
lcl|NC_002695.2_cds_NP_313315.2_4996,144,180,173,187,684
lcl|NC_002695.2_cds_NP_313316.3_4997,109,144,129,104,486
lcl|NC_002695.2_cds_NP_313317.2_4998,1463,1127,1260,1253,5103
lcl|NC_002695.2_cds_NP_313320.1_4999,204,336,327,312,1179
lcl|NC_002695.2_cds_NP_313321.3_5000,247,221,184,191,843
lcl|NC_002695.2_cds_NP_313322.1_5001,830,596,413,369,2208
lcl|NC_002695.2_cds_NP_313323.1_5002,61,61,67,78,267
lcl|NC_002695.2_cds_NP_313324.1_5003,165,173,207,223,768
lcl|NC_002695.2_cds_NP_313325.2_5004,274,263,290,325,1152
lcl|NC_002695.2_cds_NP_313326.1_5005,281,327,308,356,1272
lcl|NC_002695.2_cds_NP_313327.1_5006,200,361,328,344,1233
lcl|NC_002695.2_cds_NP_313328.1_5007,201,202,186,194,783
lcl|NC_002695.2_cds_NP_313329.1_5008,313,319,366,415,1413
lcl|NC_002695.2_cds_NP_313330.1_5009,45,33,29,58,165
lcl|NC_002695.2_cds_NP_313331.1_5010,241,256,173,212,882
lcl|NC_002695.2_cds_NP_313332.1_5011,320,334,223,287,1164
lcl|NC_002695.2_cds_YP_009502675.1_5012,82,71,91,98,342
lcl|NC_002695.2_cds_NP_313333.1_5013,584,439,344,388,1755
lcl|NC_002695.2_cds_NP_313334.2_5014,396,332,358,384,1470
lcl|NC_002695.2_cds_NP_313335.1_5015,727,503,630,573,2433
lcl|NC_002695.2_cds_NP_313336.1_5016,103,81,43,58,285
lcl|NC_002695.2_cds_NP_313337.1_5017,482,428,190,259,1359
lcl|NC_002695.2_cds_NP_313338.2_5018,230,208,263,256,957
lcl|NC_002695.2_cds_NP_313339.1_5019,60,41,48,55,204
lcl|NC_002695.2_cds_NP_313340.2_5020,402,539,596,614,2151
lcl|NC_002695.2_cds_NP_313341.1_5021,184,150,108,101,543
lcl|NC_002695.2_cds_NP_313342.1_5022,409,356,396,504,1665
lcl|NC_002695.2_cds_NP_313343.1_5023,281,374,352,355,1362
lcl|NC_002695.2_cds_NP_313344.2_5024,241,243,236,195,915
lcl|NC_002695.2_cds_NP_313345.2_5025,244,249,225,305,1023
lcl|NC_002695.2_cds_NP_313346.2_5026,564,544,589,595,2292
lcl|NC_002695.2_cds_NP_313347.2_5027,151,95,123,126,495
lcl|NC_002695.2_cds_NP_313348.1_5028,209,153,180,196,738
lcl|NC_002695.2_cds_NP_313349.1_5029,125,110,150,155,540
lcl|NC_002695.2_cds_NP_313350.2_5030,85,144,116,129,474
lcl|NC_002695.2_cds_NP_313351.3_5031,172,200,202,197,771
lcl|NC_002695.2_cds_NP_313352.1_5032,208,193,158,167,726
lcl|NC_002695.2_cds_NP_313353.3_5033,183,187,137,171,678
lcl|NC_002695.2_cds_NP_313354.1_5034,191,182,211,205,789
lcl|NC_002695.2_cds_NP_313355.3_5035,48,72,43,74,237
lcl|NC_002695.2_cds_NP_313356.1_5036,212,246,269,305,1032
lcl|NC_002695.2_cds_NP_313357.1_5037,94,81,124,115,414
lcl|NC_002695.2_cds_NP_313358.1_5038,116,98,118,115,447
lcl|NC_002695.2_cds_NP_313359.1_5039,152,163,179,184,678
lcl|NC_002695.2_cds_NP_313360.1_5040,384,348,409,449,1590
lcl|NC_002695.2_cds_NP_313361.1_5041,180,119,142,165,606
lcl|NC_002695.2_cds_YP_009502676.1_5042,25,53,36,48,162
lcl|NC_002695.2_cds_NP_313362.1_5043,238,255,278,303,1074
lcl|NC_002695.2_cds_NP_313363.2_5044,171,178,201,233,783
lcl|NC_002695.2_cds_NP_313364.1_5045,188,192,208,276,864
lcl|NC_002695.2_cds_NP_313367.1_5046,198,155,205,222,780
lcl|NC_002695.2_cds_NP_313368.2_5047,305,284,344,390,1323
lcl|NC_002695.2_cds_NP_313369.1_5048,286,272,333,333,1224
lcl|NC_002695.2_cds_NP_313370.1_5049,171,170,191,188,720
lcl|NC_002695.2_cds_NP_313371.1_5050,86,68,51,59,264
lcl|NC_002695.2_cds_NP_313372.1_5051,397,331,484,477,1689
lcl|NC_002695.2_cds_NP_313373.1_5052,221,199,252,297,969
lcl|NC_002695.2_cds_NP_313374.1_5053,291,295,354,443,1383
lcl|NC_002695.2_cds_NP_313375.2_5054,311,293,283,346,1233
lcl|NC_002695.2_cds_YP_009502677.1_5055,45,41,34,48,168
lcl|NC_002695.2_cds_NP_313376.1_5056,401,348,428,491,1668
lcl|NC_002695.2_cds_NP_313377.2_5057,467,410,487,574,1938
lcl|NC_002695.2_cds_NP_313378.2_5058,74,62,69,92,297
lcl|NC_002695.2_cds_NP_313379.2_5059,108,120,128,157,513
lcl|NC_002695.2_cds_NP_313380.1_5060,147,137,163,201,648
lcl|NC_002695.2_cds_NP_313381.1_5061,198,210,233,229,870
lcl|NC_002695.2_cds_NP_313382.1_5062,124,119,102,129,474
lcl|NC_002695.2_cds_NP_313383.1_5063,143,166,180,201,690
lcl|NC_002695.2_cds_NP_313384.1_5064,306,344,343,432,1425
lcl|NC_002695.2_cds_NP_313385.1_5065,311,371,288,383,1353
lcl|NC_002695.2_cds_NP_313386.1_5066,188,164,180,185,717
lcl|NC_002695.2_cds_NP_313388.1_5067,185,160,158,184,687
lcl|NC_002127.1_cds_NP_052604.1_5068,87,70,66,101,324
lcl|NC_002127.1_cds_NP_052605.1_5069,155,115,55,56,381
lcl|NC_002127.1_cds_NP_052606.1_5070,416,262,183,180,1041
lcl|NC_002128.1_cds_NP_052607.1_5071,773,717,539,668,2697
lcl|NC_002128.1_cds_NP_052608.1_5072,247,258,163,208,876
lcl|NC_002128.1_cds_NP_052609.1_5073,461,397,392,508,1758
lcl|NC_002128.1_cds_NP_052610.1_5074,334,364,361,447,1506
lcl|NC_002128.1_cds_NP_052611.1_5075,233,299,307,385,1224
lcl|NC_002128.1_cds_NP_052612.1_5076,109,103,96,127,435
lcl|NC_002128.1_cds_NP_052613.1_5077,118,141,113,183,555
lcl|NC_002128.1_cds_NP_052614.1_5078,76,70,77,125,348
lcl|NC_002128.1_cds_NP_052615.1_5079,123,148,139,190,600
lcl|NC_002128.1_cds_NP_052616.1_5080,225,228,219,306,978
lcl|NC_002128.1_cds_NP_052617.1_5081,183,182,211,273,849
lcl|NC_002128.1_cds_NP_052618.1_5082,119,122,121,151,513
lcl|NC_002128.1_cds_NP_052619.1_5083,120,219,164,214,717
lcl|NC_002128.1_cds_NP_052620.1_5084,116,106,81,99,402
lcl|NC_002128.1_cds_NP_052621.1_5085,123,65,80,74,342
lcl|NC_002128.1_cds_NP_052622.1_5086,218,169,195,240,822
lcl|NC_002128.1_cds_NP_052623.1_5087,176,144,65,107,492
lcl|NC_002128.1_cds_NP_052624.1_5088,983,836,466,712,2997
lcl|NC_002128.1_cds_NP_052625.1_5089,639,689,343,450,2121
lcl|NC_002128.1_cds_NP_052626.1_5090,496,417,215,312,1440
lcl|NC_002128.1_cds_NP_958720.1_5091,74,68,29,24,195
lcl|NC_002128.1_cds_NP_052627.1_5092,101,89,43,52,285
lcl|NC_002128.1_cds_NP_958721.1_5093,62,68,62,39,231
lcl|NC_002128.1_cds_NP_052628.1_5094,159,154,220,208,741
lcl|NC_002128.1_cds_NP_052629.1_5095,65,67,92,94,318
lcl|NC_002128.1_cds_NP_052630.2_5096,244,219,267,248,978
lcl|NC_002128.1_cds_NP_052631.1_5097,72,94,85,79,330
lcl|NC_002128.1_cds_NP_958722.1_5098,57,48,53,43,201
lcl|NC_002128.1_cds_NP_052632.1_5099,166,131,140,184,621
lcl|NC_002128.1_cds_NP_052633.1_5100,122,89,231,242,684
lcl|NC_002128.1_cds_NP_052634.1_5101,61,47,46,65,219
lcl|NC_002128.1_cds_NP_052635.1_5102,78,74,69,85,306
lcl|NC_002128.1_cds_NP_052636.1_5103,173,175,221,238,807
lcl|NC_002128.1_cds_NP_052637.1_5104,220,190,209,272,891
lcl|NC_002128.1_cds_NP_052638.1_5105,75,75,79,98,327
lcl|NC_002128.1_cds_NP_052640.1_5106,300,317,250,300,1167
lcl|NC_002128.1_cds_NP_052641.1_5107,257,268,204,243,972
lcl|NC_002128.1_cds_NP_052642.1_5108,486,427,365,447,1725
lcl|NC_002128.1_cds_NP_052643.1_5109,194,215,208,286,903
lcl|NC_002128.1_cds_NP_052644.1_5110,45,63,101,97,306
lcl|NC_002128.1_cds_NP_052645.1_5111,146,148,193,197,684
lcl|NC_002128.1_cds_NP_958723.1_5112,50,52,55,65,222
lcl|NC_002128.1_cds_NP_052646.1_5113,131,110,151,163,555
lcl|NC_002128.1_cds_NP_052647.1_5114,151,151,222,253,777
lcl|NC_002128.1_cds_NP_052648.1_5115,88,128,182,175,573
lcl|NC_002128.1_cds_NP_052649.1_5116,60,72,81,90,303
lcl|NC_002128.1_cds_NP_052650.1_5117,98,90,86,149,423
lcl|NC_002128.1_cds_NP_052651.1_5118,43,110,131,106,390
lcl|NC_002128.1_cds_NP_052652.1_5119,51,47,75,58,231
lcl|NC_002128.1_cds_NP_052653.1_5120,348,236,372,406,1362
lcl|NC_002128.1_cds_NP_052654.1_5121,102,131,153,178,564
lcl|NC_002128.1_cds_NP_052655.1_5122,132,50,128,146,456
lcl|NC_002128.1_cds_NP_052656.1_5123,108,80,117,148,453
lcl|NC_002128.1_cds_NP_958724.1_5124,57,60,54,63,234
lcl|NC_002128.1_cds_NP_052657.1_5125,440,371,518,630,1959
lcl|NC_002128.1_cds_NP_052658.1_5126,92,95,110,138,435
lcl|NC_002128.1_cds_NP_052659.1_5127,169,144,201,248,762
lcl|NC_002128.1_cds_NP_052660.1_5128,38,46,32,43,159
lcl|NC_002128.1_cds_NP_052661.1_5129,490,458,404,622,1974
lcl|NC_002128.1_cds_NP_052662.1_5130,135,105,76,116,432
lcl|NC_002128.1_cds_NP_052663.1_5131,94,82,87,97,360
lcl|NC_002128.1_cds_NP_052664.1_5132,113,91,91,116,411
lcl|NC_002128.1_cds_NP_052665.1_5133,3549,2975,1364,1622,9510
lcl|NC_002128.1_cds_NP_052666.1_5134,70,57,65,81,273
lcl|NC_002128.1_cds_NP_052667.1_5135,131,112,123,138,504
lcl|NC_002128.1_cds_NP_052669.1_5136,124,189,190,244,747
lcl|NC_002128.1_cds_NP_052670.1_5137,244,234,153,230,861
lcl|NC_002128.1_cds_NP_052671.1_5138,157,86,145,173,561
lcl|NC_002128.1_cds_NP_958725.1_5139,49,35,52,77,213
lcl|NC_002128.1_cds_NP_052672.1_5140,120,115,95,132,462
lcl|NC_002128.1_cds_NP_958726.1_5141,88,47,33,42,210
lcl|NC_002128.1_cds_NP_052673.1_5142,86,88,75,90,339
lcl|NC_002128.1_cds_NP_052674.1_5143,88,55,49,63,255
lcl|NC_002128.1_cds_NP_052675.1_5144,183,181,237,257,858
lcl|NC_002128.1_cds_NP_052676.1_5145,75,54,77,79,285
lcl|NC_002128.1_cds_NP_052677.1_5146,71,71,60,74,276
lcl|NC_002128.1_cds_NP_052678.1_5147,77,53,32,45,207
lcl|NC_002128.1_cds_NP_052681.1_5148,103,108,124,130,465
lcl|NC_002128.1_cds_NP_052684.1_5149,218,194,208,268,888
lcl|NC_002128.1_cds_NP_052685.1_5150,1200,974,843,886,3903
lcl|NC_002128.1_cds_NP_958727.1_5151,73,65,74,61,273
lcl|NC_002128.1_cds_NP_052686.1_5152,119,124,90,105,438
lcl|NC_002128.1_cds_NP_052687.1_5153,271,274,259,303,1107
lcl|NC_002128.1_cds_NP_052688.1_5154,434,463,407,418,1722
lcl|NC_002128.1_cds_NP_052689.1_5155,255,274,209,261,999
